Wot, Wot, Wot, Wwt, Wwt, Wwt, Ds, Ds, Gs^Ft, Gll^Ftr, Gll^Ftr, Gll^Ftr, Gll^Ftr, Gll^Ftr, Gll^Ftr, Gll^Ftr, Ds, Wwt, Wwt, Wot, Wot, Wot, Wot, Wot, Wwt, Wwt, Ds, Gs^Ft, Gll^Ftr, Gll^Ftr, Gll^Ftr, Gs^Ft, Gs^Ft, Gll^Ftr, Ds, Ds, Wwt, Wwt, Wwt, Wwt, Wwt, Wwt, Dd^Ftd, Ds, Gs^Ft, Ds, Dd^Ftd, Dd^Ftd, Dd^Ftd, Wwt, Wwt, Wot
Wot, Wot, Wwt, Wwt, Wwt, Ds, Dd^Ftd, Gll^Ftr, Gll^Ftr, Gs^Ft, Gll^Ftr, Gll^Ftr, Gs^Ft, Gll^Ftr, Gs^Ft, Gll^Ftr, Ds, Ds, Ds, Wwt, Wwt, Wot, Wwrt, Wwt, Wwt, Wwt, Dd^Ftd, Gs^Ft, Gll^Ftr, Gs^Ft, Dd^Ftd, Gll^Ftr, Dd^Ftd, Dd^Ftd, Dd^Ftd, Ww^Vm, Wwt, Wwt, Wwt, Wwt, Wwt, Dd^Ftd, Gs^Ft, Gs^Ft, Gll^Ftr, Gs^Ft, Gll^Ftr, Gll^Ftr, Gll^Ftr, Ds, Wwt, Wwt
Wot, Wot, Wwt, Wwt, Wwt, Ds, Gll^Ftr, Gs^Ft, Gll^Ftr, Gll^Ftr, Gll^Ftr, Gs^Ftp, Gll^Ftr, Gs^Ft, Gll^Ftr, Gll^Ftr, Gs^Ft, Gll^Ftr, Dd^Ftd, Wwt, Wwt, Wwt, Wwrt, Wwrt, Wwrt, Wwt, Wwt, Dd^Ftd, Ds, Ds, Wwrt, Dd^Ftd, Ds, Ds, Wwt, Wwt, Wwt, Wot, Wot, Wwt, Wwt, Dd^Ftd, Gs^Ft, Gs^Ft, Gll^Ftr, Gll^Ftr, Gs^Ft, Gs^Ft, Gs^Ft, Dd^Ftd, Wwt, Wwt
Wot, Wot, Wwt, Wwt, Wwt, Ds, Ds, Gll^Ftr, Gll^Ftr, Gs^Ftp, Gll^Ftr, Gs^Ftp, Gll^Ftr, Gs^Ft, Gs^Ft, Gll^Ftr, Gll^Ftr, Gll^Ftr, Ds, Wwt, Wwt, Wwt, Wwt, Wwrt, Wwt, Wwt, Wwt, Wwrt, Wwt, Wwrt, Wwrt, Wwrt, Wwt, Wwt, Wwt, Wwt, Wwt, Wot, Wwt, Wwt, Wwt, Dd^Ftd, Gs^Ft, Gll^Ftr, Gll^Ftr, Gll^Ftr, Gs^Ft, Gs^Ft, Gs^Ft, Dd^Ftd, Wwt, Wwt
Wot, Wot, Wwt, Wwt, Wwt, Wwr, Wwr, Dd^Ftd, Dd^Ftd, Gll^Ftr, Gll^Ftr, Gll^Ftr, Gll^Ftr, Gll^Ftr, Gll^Ftr, Gll^Ftr, Gll^Ftr, Gll^Ftr, Dd^Ftd, Wwt, Wwt, Wwt, Wot, Wwrt, Wwt, Wwt, Wot, Wwt, Wwt, Wwt, Wwt, Wwt, Wwt, Wwt, Wwt, Wwt, Wwrt, Wwt, Wwt, Wwt, Wwt, Ds, Gs^Ft, Gs^Ft, Gs^Ft, Gs^Ft, Gll^Ftr, Gs^Ft, Gs^Ft, Ds, Wwt, Wwt
Wot, Wot, Wot, Wwt, Wwt, Wwt, Wwt, Ds, Dd^Ftd, Gll^Ftr, Gll^Ftr, Gll^Ftr, Gll^Ftr, Gll^Ftr, Gll^Ftr, Gll^Ftr, Ds, Dd^Ftd, Wwt, Wwt, Wwrt, Wot, Wot, Wwt, Wwt, Wot, Cme, Cm, Cm, Cm, Cme, Wot, Wwt, Wwt, Wwrt, Wwrt, Wot, Wwrt, Wwt, Wwt, Wwt, Dd^Ftd, Ds, Gll^Ftr, Dd^Ftd, Gll^Ftr, Dd^Ftd, Gll^Ftr, Ds, Dd^Ftd, Wwt, Wwt
Wot, Wot, Wwt, Wwt, Wwr, Wwr, Ds, Ds, Dd^Ftd, Gll^Ftr, Gll^Ftr, Gll^Ftr, Gll^Ftr, Gll^Ftr, Gll^Ftr, Gll^Ftr, Dd^Ftd, Wwt, Wwt, Wwrt, Wot, Wot, Wot, Wwt, Wwt, Cme, Wot, Wwt, Cm, Wwt, Wot, Cme, Wwt, Wwt, Wot, Wot, Wwrt, Wwrt, Wwt, Wwt, Wwt, Wwt, Wwt, Dd^Ftd, Wwt, Dd^Ftd, Wwt, Dd^Ftd, Wwt, Wwt, Wot, Wot
Wot, Wot, Wwt, Wwt, Wwr, Dd^Ftd, Gll^Ftr, Gll^Ftr, Gs^Ftp, Gs^Ftp, Gs^Ftp, Gll^Ftr, Gs^Ftp, Gll^Ftr, Gll^Ftr, Dd^Ftd, Dd^Ftd, Wwt, Wwt, Wwrt, Wwrt, Wot, Wwrt, Wwt, Wwt, Cme, Wwt, Ww^Vm, Km, Ww^Vm, Wot, Cme, Wwt, Wwt, Wot, Wot, Wwrt, Wwrt, Wwt, Wwt, Wot, Wwt, Wwt, Wwt, Wwt, Wwt, Wwt, Wwt, Wot, Wot, Wot, Wot
Wot, Wwt, Wwt, Wwt, Wwt, Ds, Gs^Ft, Gll^Ftr, Gs^Ft, Gs^Ft, Gll^Ftr, Gs^Ftp, Gll^Ftr, Gll^Ftr, Gll^Ftr, Gll^Ftr, Ds, Wwt, Wwt, Wwt, Wwrt, Wwrt, Wwt, Wwt, Wwt, Cm, Cm, Cm, Ww^Vm, Cm, Cm, Cm, Wwt, Wwt, Wot, Wot, Wwt, Wwt, Wwt, Wot, Wot, Wot, Wwt, Wwt, Wwt, Wwt, Wwt, Wwt, Wwt, 1 Wot, Wot, Wot
Wot, Wwt, Wwt, Wwt, Wwt, Dd^Ftd, Dd^Ftd, Gs^Ft, Ds, Gs^Ft, Gs^Ft, Gll^Ftr, Gll^Ftr, Gll^Ftr, Ds, Ds, Ds, Wwt, Wwt, Wwt, Wwrt, Wwrt, Wwrt, Wwrt, Wwt, Wot, Cm, Wot, Wwt, Wwt, Cm, Wwrt, Wwt, Wot, Wot, Wwt, Wwt, Wwt, Wwt, Wwt, Wwt, Wwt, Wwrt, Wwrt, Wwrt, Wwt, Wwt, Wwt, Wwt, Wot, Wot, Wot
Wot, Wwt, Wwt, Wwt, Wwt, Wwt, Wwt, Ds, Ww^Vm, Dd^Ftd, Dd^Ftd, Dd^Ftd, Ds, Dd^Ftd, Dd^Ftd, Dd^Ftd, Wwt, Wwrt, Wwrt, Wwrt, Wwt, Wwrt, Wot, Wot, Wwt, Wwt, Wwt, Cme, Cme, Cme, Wwt, Wwrt, Wwt, Wwt, Wwt, Wwt, Dd^Ftd, Wwt, Ds, Wwt, Wwt, Wwrt, Dd^Ftd, Dd^Ftd, Ds, Ds, Dd^Ftd, Wwt, Wwt, Wwt, Wwt, Wot
Wot, Wwrt, Wwt, Wwt, Wwt, Wwt, Wot, Wwt, Wwt, Wwt, Wwt, Wwt, Wwt, Wwt, Wwt, Wwt, Wwt, Wwt, Wwt, Wwt, Wwt, Wwt, Wwt, Wwt, Wwrt, Wwt, Wwt, Wwt, Wot, Wot, Wwt, Wwt, Wwt, Wwt, Dd^Ftd, Dd^Ftd, Gs^Ft, Dd^Ftd, Gs^Ft, Ds, Hh, Ds, Hh, Dd^Ftd, Gll^Ftr, Dd^Ftd, Dd^Ftd, Dd^Ftd, Wwt, Wwt, Wwt, Wot
Wot, Wwrt, Wwt, Wwt, Wot, Wot, Wot, Wot, Wwt, Wwt, Wwt, Wwt, Wwt, Wwt, Wwt, Wwt, Wwt, Wwt, Ds, Wwt, Ds, Wwt, Wwt, Wwrt, Wot, Wwt, Wot, Wwt, Wwt, Wwt, Wwt, Wwt, Wwt, Dd^Ftd, Gs^Ft, Gs^Ftp, Gll^Ftr, Gll^Ftr, Mm, Gs^Ft, Mm, Hh, Hh, Gll^Ftr, Gll^Ftr, Gs^Ftp, Dd^Ftd, Ds, Wwt, Wwt, Wwt, Wot
Wwt, Wwt, Wwt, Wot, Wot, Wwrt, Wot, Wwt, Wwt, Wwt, Wwrt, Wwrt, Wwrt, Wwt, Dd^Ftd, Dd^Ftd, Dd^Ftd, Ds, Dd^Ftd, Dd^Ftd, Dd^Ftd, Wwt, Wwt, Wwrt, Wwrt, Wot, Wot, Wot, Wwrt, Wwt, Wwt, Wwt, Dd^Ftd, Ds, Hh, Gs^Ftp, Mm, Mm, Mm, Mm, Mm, Mm, Mm, Mm, Gs^Ft, Gs^Ftp, Ds, Dd^Ftd, Wwt, Wwt, Wwt, Wot
Gs^Ft, Wwt, Wwrt, Wwt, Wwt, Wot, Wwrt, Wwrt, Wwt, Wwt, Ds, Dd^Ftd, Ds, Ds, Gs^Ft, Dd^Ftd, Gs^Ft, Gs^Ft, Gs^Ft, Dd^Ftd, Ds, Wwt, Wwt, Wwt, Wwt, Wot, Wot, Wot, Wot, Wwt, Wwt, Wwt, Dd^Ftd, Hh, Hh, Mm, Mm, Mm, Mm, Mm, Mm, Mm, Mm, Mm, Dd^Ftd, Dd^Ftd, Ds, Wwrt, Wwt, Wwt, Wwt, Wot
Gs^Ft, Ds, Dd^Ftd, Wwrt, Wwt, Wwt, Wwt, Wwrt, Dd^Ftd, Ds, Gs^Ft, Ds, Gs^Ft, Gll^Ftr, Gll^Ftr, Gll^Ftr, Mm, Gs^Ft, Gs^Ft, Gs^Ft, Gs^Ft, Dd^Ftd, Dd^Ftd, Wwt, Wwt, Wwrt, Wwrt, Wot, Wot, Wot, Wwt, Wwt, Dd^Ftd, Gs^Ft, Gll^Ftr, Mm, Mm, Mm, Hh, Mm, Gs^Ft, Mm, Hh, Hh, Dd^Ftd, Ds, Wwrt, Wwrt, Wwt, Wwt, Wot, Wot
Gs^Ft, Gs^Ft, Gs^Ft, Dd^Ftd, Ds, Wwrt, Ds, Dd^Ftd, Gs^Ft, Gs^Ft, Gs^Ft, Gs^Ft, Mm, Mm, Mm, Mm, Mm, Mm, Mm, Gs^Ft, Gs^Ft, Dd^Ftd, Wwt, Wwt, Wwt, Wwrt, Wwt, Wwt, Wwt, Wwrt, Wwt, Wwt, Ds, Gs^Ftp, Gll^Ftr, Gll^Ftr, Gs^Ftp, Gs^Ft, Ds, Ds, Dd^Ftd, Dd^Ftd, Ds, Dd^Ftd, Wwt, Wwrt, Wwt, Wwt, Wwt, Wwt, Wot, Wot
Gs^Ft, Gs^Ft, Gs^Ft, Dd^Ftd, Dd^Ftd, Ds, Dd^Ftd, Dd^Ftd, Gs^Ft, Gs^Ft, Gll^Ftr, Gll^Ftr, Mm, Mm, Mm, Mm, Mm, Mm, Dd^Ftd, Gs^Ft, Ds, Wwt, Wwt, Wwt, Wwt, Wwt, Wwt, Wwt, Wwt, Wwt, Wwt, Wwt, Wwt, Ds, Dd^Ftd, Gll^Ftr, Dd^Ftd, Dd^Ftd, Ds, Ww^Vm, Wwt, Ds, Wwt, Wwt, Wwt, Wwt, Wwt, Wwt, Wwt, Wot, Wot, Wot
Gs^Ft, Gs^Ft, Gll^Ftr, Gs^Ft, Dd^Ftd, Wwt, Dd^Ftd, Gll^Ftr, Gll^Ftr, Gll^Ftr, Gs^Ft, Mm, Gs^Ft, Mm, Wwrt, Gs^Ft, Dd^Ftd, Dd^Ftd, Wwt, Dd^Ftd, Wwt, Wwt, Wwt, Wwt, Wwrt, Gs^Ft, Gs^Ft, Ds, Ds, Wwt, Wwt, Wot, Wot, Wwt, Wwt, Ds, Ds, Ds, Wwt, Wwt, Wwt, Wwt, Wwt, Wwt, Wwt, Wwt, Wwt, Wwt, Wot, Wot, Wot, Wot
Gs^Ft, Gs^Ft, Gll^Ftr, Gll^Ftr, Dd^Ftd, Wwt, Dd^Ftd, Gll^Ftr, Gll^Ftr, Gs^Ft, Gs^Ft, Gs^Ft, Ds, Ww^Vm, Wwrt, Dd^Ftd, Wwt, Wwt, Wwt, Wwt, Wwt, Wwt, Wwt, Wwt, Mm, Mm, Mm, Gs^Ft, Gs^Ft, Dd^Ftd, Wwt, Wwt, Wwt, Wwt, Wwt, Wwt, Wwt, Wwt, Wwrt, Wwrt, Wwrt, Wwt, Wot, Wot, Wot, Wot, Wot, Wot, Wot, Wot, Wot, Wot
Gs^Ft, Gs^Ft, Gs^Ft, Gll^Ftr, Dd^Ftd, Wwt, Dd^Ftd, Gll^Ftr, Gs^Ft, Gs^Ft, Gs^Ft, Gs^Ft, Ds, Dd^Ftd, Wwt, Wwt, Wwrt, Wwrt, Wwt, Wwt, Wwrt, Wwrt, Mm, Mm, Mm, Mm, Mm, Gs^Ft, Gs^Ft, Dd^Ftd, Ds, Wwt, Wwrt, Wwrt, Wwrt, Wwt, Wot, Wwt, Wwrt, Wwrt, Wwt, Wwt, Wwt, Wwt, Wwt, Wwt, Wwt, Wwt, Wwt, Wot, Wwt, Wot
Gs^Ft, Gs^Ft, Gll^Ftr, Dd^Ftd, Wwt, Wwt, Dd^Ftd, Gll^Ftr, Gs^Ft, Gs^Ft, Gll^Ftr, Gll^Ftr, Gll^Ftr, Dd^Ftd, Wwrt, Wwt, Wwt, Wwrt, Wwt, Wwt, Gs^Ft, Mm, Mm, Mm, Mm, Mm, Gs^Ft, Gs^Ft, Gs^Ft, Dd^Ftd, Ds, Wwt, Wwt, Wwt, Wwrt, Wwt, Wot, Wot, Wwt, Wwt, Wwt, Wwt, Wwrt, Wwrt, Wwrt, Wwt, Wwt, Wwt, Wwrt, Wwt, Wwrt, Wwt
Gll^Ftr, Gll^Ftr, Gll^Ftr, Dd^Ftd, Dd^Ftd, Wwt, Wwt, Dd^Ftd, Gll^Ftr, Gll^Ftr, Gll^Ftr, Gll^Ftr, Gll^Ftr, Dd^Ftd, Ds, Wwrt, Dd^Ftd, Wwt, Ds, Mm, Mm, Mm, Mm, Mm, Mm, Gs^Ftp, Gll^Ftr, Gs^Ft, Ds, Ds, Wwrt, Wwt, Wwt, Wwt, Wwt, Wwt, Wwt, Wwt, Ds, Dd^Ftd, Dd^Ftd, Dd^Ftd, Ds, Ds, Dd^Ftd, Ds, Wwt, Wwt, Ds, Wwrt, Wwrt, Wwt
Gs^Ft, Gll^Ftr, Gs^Ft, Gs^Ft, Dd^Ftd, Wwt, Wwt, Ds, Ds, Dd^Ftd, Dd^Ftd, Gll^Ftr, Gll^Ftr, Gs^Ft, Gs^Ft, Dd^Ftd, Dd^Ftd, Ds, Gs^Ft, Mm, Mm, Mm, Mm, Mm, Gll^Ftr, Gll^Ftr, Gs^Ft, Gll^Ftr, Ds, Wwrt, Wwt, Wwt, Wwt, Wwt, Ds, Wwt, Dd^Ftd, Ds, Dd^Ftd, Dd^Ftd, Gll^Ftr, Gll^Ftr, Gll^Ftr, Gll^Ftr, Gll^Ftr, Wwt, Gll^Ftr, Gll^Ftr, Gll^Ftr, Dd^Ftd, Dd^Ftd, Wwt
Gs^Ft, Gs^Ft, Gs^Ft, Gll^Ftr, Ds, Wwt, Wwrt, Wwt, Wwt, Wwrt, Dd^Ftd, Gll^Ftr, Gll^Ftr, Gll^Ftr, Gs^Ft, Gs^Ft, Gs^Ft, Gs^Ft, Gs^Ft, Mm, Gs^Ftp, Mm, Gs^Ft, Gll^Ftr, Gs^Ft, Gs^Ft, Dd^Ftd, Ds, Wwt, Wwt, Wwt, Wwt, Dd^Ftd, Dd^Ftd, Gs^Ft, Dd^Ftd, Gs^Ft, Gll^Ftr, Gll^Ftr, Gll^Ftr, Gll^Ftr, Gll^Ftr, Gll^Ftr, Gll^Ftr, Gll^Ftr, Wwt, Gll^Ftr, Gll^Ftr, Gll^Ftr, Gll^Ftr, Gll^Ftr, Dd^Ftd
Gs^Ft, Gs^Ft, Gs^Ft, Ds, Wwt, Wwrt, Wwt, Wwt, Wwt, Wwt, Wwt, Dd^Ftd, Dd^Ftd, Gll^Ftr, Gs^Ft, Gs^Ft, Gs^Ftp, Gs^Ftp, Gs^Ft, Gs^Ft, Gs^Ft, Gs^Ftp, Gs^Ft, Gs^Ft, Ds, Dd^Ftd, Wwt, Wwt, Wwt, Wwt, Wwt, Wwt, Dd^Ftd, Gs^Ft, Gll^Ftr, Gs^Ftp, Gll^Ftr, Gll^Ftr, Gll^Ftr, Gll^Ftr, Gll^Ftr, Gll^Ftr, Gll^Ftr, Gll^Ftr, Gll^Ftr, Wwt, Gll^Ftr, Gll^Ftr, Gll^Ftr, Gs^Ft, Gs^Ft, Gll^Ftr
Gll^Ftr, Gll^Ftr, Gs^Ft, Dd^Ftd, Wwt, Wwt, Wwt, Wwrt, Wwrt, Wwt, Wwt, Ww^Vm, Dd^Ftd, Gs^Ft, Gll^Ftr, Gll^Ftr, Gll^Ftr, Gll^Ftr, Gll^Ftr, Gs^Ft, Gs^Ft, Gs^Ft, Ds, Ds, Wwrt, Wwrt, Wwt, Wwt, Wot, Wwt, Wwt, Wwrt, Ds, Gll^Ftr, Gll^Ftr, Gll^Ftr, Gll^Ftr, Gll^Ftr, Gll^Ftr, Gll^Ftr, Gll^Ftr, Gll^Ftr, Ds, Gll^Ftr, Wwt, Wwt, Gll^Ftr, Gll^Ftr, Gll^Ftr, Gs^Ft, Gs^Ft, Gll^Ftr
Gll^Ftr, Gs^Ft, Dd^Ftd, Dd^Ftd, Wwrt, Wwrt, Wwt, Chw, Wwt, Wwt, Wwt, Wwrt, Dd^Ftd, Gs^Ft, Gs^Ft, Gs^Ft, Gs^Ft, Gll^Ftr, Gs^Ft, Gs^Ft, Gs^Ft, Gs^Ft, Dd^Ftd, Dd^Ftd, Wwt, Wwt, Wwt, Wwt, Wot, Wwt, Wwt, Wwrt, Wwrt, Gll^Ftr, Gll^Ftr, Gll^Ftr, Gll^Ftr, Gll^Ftr, Wwt, Gll^Ftr, Gll^Ftr, Ds, Wwrt, Wwrt, Wwt, Gll^Ftr, Gll^Ftr, Gll^Ftr, Gs^Ft, Gll^Ftr, Gs^Ft, Gll^Ftr
Gs^Ft, Gll^Ftr, Gs^Ft, Dd^Ftd, Ds, Wwrt, Wwrt, Wwt, Wwt, Wwt, Wwrt, Dd^Ftd, Gs^Ft, Gs^Ft, Gll^Ftr, Gll^Ftr, Gll^Ftr, Gs^Ft, Gs^Ft, Gs^Ft, Gs^Ft, Ds, Dd^Ftd, Dd^Ftd, Wwt, Wwt, Wwt, Wot, Wot, Wot, Wwt, Wwt, Wwt, Wwt, Wwt, Wwt, Wwt, Wwt, Gll^Ftr, Wwt, Wwt, Wwt, Wwt, Ww^Vm, Wwt, Dd^Ftd, Gll^Ftr, Gs^Ft, Gll^Ftr, Gs^Ft, Gs^Ft, Gs^Ft
Gll^Ftr, Gll^Ftr, Gll^Ftr, Gs^Ft, Gll^Ftr, Dd^Ftd, Dd^Ftd, Wwrt, Ds, Dd^Ftd, Dd^Ftd, Dd^Ftd, Gll^Ftr, Gll^Ftr, Gs^Ft, Gll^Ftr, Gll^Ftr, Gll^Ftr, Gll^Ftr, Gs^Ft, Gs^Ft, Ds, Ds, Wwrt, Wwrt, Wwt, Wot, Wot, Wot, Wwt, Wwt, Wwt, Ds, Gll^Ftr, Gll^Ftr, Gll^Ftr, Gll^Ftr, Gll^Ftr, Gll^Ftr, Gll^Ftr, Gll^Ftr, Ds, Gll^Ftr, Wwrt, Ds, Dd^Ftd, Gll^Ftr, Gll^Ftr, Gs^Ft, Gll^Ftr, Gs^Ft, Gs^Ft
Gll^Ftr, Gll^Ftr, Gll^Ftr, Gll^Ftr, Gll^Ftr, Gs^Ft, Gs^Ft, Dd^Ftd, Gs^Ft, Dd^Ftd, Gs^Ft, Gs^Ft, Gll^Ftr, Gll^Ftr, Gs^Ft, Gll^Ftr, Gs^Ft, Gs^Ft, Gs^Ft, Gs^Ft, Gs^Ft, Gs^Ft, Dd^Ftd, Dd^Ftd, Wwt, Wwt, Wot, Wot, Wot, Wot, Wwt, Wwt, Ds, Gs^Ft, Gs^Ft, Gll^Ftr, Gll^Ftr, Gll^Ftr, Gll^Ftr, Gll^Ftr, Gll^Ftr, Gll^Ftr, Gll^Ftr, Gll^Ftr, Gll^Ftr, Gll^Ftr, Gs^Ft, Gs^Ft, Gs^Ft, Gll^Ftr, Gs^Ft, Gs^Ft
Ds, Gs^Ft, Gs^Ft, Gll^Ftr, Gll^Ftr, Gs^Ft, Ds, Gs^Ft, Gs^Ft, Gs^Ft, Gs^Ft, Gs^Ft, Gs^Ft, Gs^Ft, Gs^Ft, Gs^Ft, Gs^Ft, Gs^Ft, Gs^Ft, Gs^Ft, Ds, Ds, Dd^Ftd, Dd^Ftd, Wwt, Wot, Wot, Wot, Wot, Wot, Wwt, Wwt, Ds, Gs^Ft, Gs^Ft, Gs^Ft, Gs^Ft, Gs^Ft, Gs^Ft, Gs^Ft, Gs^Ft, Gs^Ft, Gs^Ft, Gs^Ft, Gs^Ft, Gs^Ft, Gs^Ft, Gs^Ft, Gs^Ft, Gs^Ft, Gs^Ft, Gs^Ft
