Gg, Gg, Hh^Fds, Mm, Mm, Mm, Hh, Gg, Gg^Fms, Gd, Gd, Wwt, Gd, Gd^Ft, Mm, Mm, Mm, Mm, Mm, Mm, Mm, Mm, Mm, Mm, Mm, Hh, Hh, Gg, Gg, Gg, Gd, Gg, Gd
Gg^Fds, Gll^Fds, Gg^Ftp, Hh^Ftd, Gg, Hh^Fds, Hh^Fds, Gg^Fds, Gg, Ds, Wwt, Wwt, Gg^Ftp, Hh^Fms, Mm, Mm, Mm, Mm, Mm, Mm, Gg, Hh^Fds, Hh, Hh, Gs, Mm, Gg, Hh, Gd, Gd, Gd, Gg, Hh
Gd, Gd, Gd, Gd, Gd^Fds, Gg^Fds, Gd, Gll^Fds, Gg, Wwt, Wwt, Gs, Gd, Hh^Fms, Gll^Fms, Mm^Fms, Hh^Fms, Mm, Hh, Mm, Gd^Ftd, Gg^Fds, Gd^Fds, Gg^Fds, Gg^Ftp, Gll^Fms, Gg^Fms, Gg, Gd, Gd, Gg^Fds, Hh^Fds, Hh^Fds
Ds, Gg, Gg, Gs, Gg, Gd, Gs, Gg, Ds, Wwt, Wwt, Ds, Ds, Gg, Dd, Hh, Ds^Vct, Gg, Mm, Mm, Gd, Gd^Fms, Gg, Gd, Gg, Gg^Fms, Gs, Gs, Gg, Gg, Ss, Hh^Fds, Gd
Ds, Dd, Dd^Vda, Ds, Wwrt, Gg, Ds, Ds^Vdt, Ds, Gg, Wwt, Ds, Wwt, Ds, Ds, Ds, Ds, Ds, Cm, Mm, Ds, Ds^Ftd, Ds, Gg, Ds^Vdt, Ds, Dd, Ds, Ds, Ds, Dd, Gg^Fms, Gd
Wwt, Ds, Wwt, Ds, Wwt, Ds, Wwt, Ds, Wwt, Ds, Wwt, Wwt, Wwt, Wwt, Wwt, Wwt, Wwf^Vm, Cm, Cm, Km, Cm, Ds, Ds, Ds, Ds, Ds, Wwrt, Ds, Chw, Chw, Khw, Ds, Ds
Wwt, Wwt, Wwt, Wwt, Ww^Vm, Wwt, Wwt, Wwt, Wwt, Wwt, Wwt, Wwt, Wwt, Cm, Cm, Wwt, Wwt, Cm, Cm, Cm, Cm, Cm, Wwt, Wwt^Bw|, Wwt, Ds, Ds, Ds, Wwt, Wwt, Dd, Ds, Gg^Fms
Wwt, Wwt, Wwt, Wwrt, Wwt, Wwrt, Wwt, Cm, Wwt, Wwt, Wot, Wwt, Wot, Cm, Wwt, Wwt, Wwt, Wwt, Wwt, Wwt, Wwt, Wwt^Vm, Wwt, Wwt, Wwt, Wwt, Wwt, Wwt, Wwt, Ds, Ds, Ds, Gg^Ftp
Wwt, Wwt, Wwt, Wwt, Wwt, Wwt, Wot, Wot, Wot, Wot, Wot, Wot, Wot, Wot, Wot, Wwt, Wwt, Wwt, Wwf^Vm, Wwt, Wwt, Wwt, Wwt, Wwt, Wwt, Wwt, Wwt, Wwt, Ww^Vm, Wwt, Wwt, Ds^Vct, Ds^Ftp
Wot, Wot, Wot, Wot, Wot, Wot, Wot, Wot, Wot, Wot, Wot, Wot, Wot, Wot, Wot, Cm, Wwt, Ds, Ds, Ds, Wwt, Wwt, Wwt, Wwt, Wwt, Wwt, Wwt, Wwt, Wwt, Wwt, Wwt^Bw/, Ds, Dd^Do
Wot, Wot, Wot, Wot, Wot, Wot, Wot, Wot, Wot^Vm, Wot, Wot, Wot, Wot, Wot, Wot, Wwt, Wwt, Wwt, Wwt, Wwt, Wot, Wot, Wot, Wwt, Cm, Wwt, Wot, Wwt, Wwt, Wwt, Wwt, Ds, Ds
Wot, Wot, Wot, Wot, Wot, Wot, Wot, Wot, Wot, Wot, Wot, Wot, Wot, Wot, Wot, Wot, Wot, Wot, Wot, Wwt, Wot, Wot, Wot, Wot, Wot, Wot, Wot, Wot, Wot, Wwt, Wwt, Wwt, Wwt
Wot, Wot, Wot, Wot, Wot, Wot, Wot, Wot, Wot, Wot, Wot, Wot, Wot, Wot, Wot, Wot, Wot, Wot, Wot, Wot, Wot, Wot, Wot, Wot, Wot, Wot, Wot, Wot, Wot, Wot, Wwt, Wwt, Wwt
