Xos, Xos, Xos, Xos, Xos, Xos, Xos, Xos, Xos, Xos, Xos, Xos, Xos, Xos, Xos, Xos, Xos, Xos, Xos, Xos, Xos, Xos, Xos, Xos, Xos, Xos, Xos, Xos, Xos, Xos, Xos, Xos, Xos, Xos, Xos, Xos, Xos, Xos, Xos, Xos, Xos, Xos, Xos, Xos, Xos, Xos, Xos, Xos, Xos, Xos
Xos, Xos, Xos, Xos, Xos, Xos, Xos, Xos, Xoc, Xoc, Xoc, Xoc, Xoc, Xoc, Xoc, Xoc, Xoc, Xoc, Xoc, Xoc, Xoc, Xos, Xoc, Xos, Xoc, Xoc, Xoc, Xos, Xos, Xos, Xos, Xos, Xos, Xos, Xos, Xos, Xos, Xos, Xos, Xos, Xos, Xos, Xos, Xos, Xos, Xos, Xos, Xos, Xos, Xos
Xos, Xos, Xos, Xos, Xos, Xos, Xos, Xos, Xoc, Xoc, Cm, Cm, Cm, Xoc, Xoc, Xoc, Xoc, Xoc, Cm^Vm, Xoc, Xoc, Xoc, Xoc, Cm, Cm, Xoc, Xoc, Xos, Xos, Xos, Xos, Xos, Xos, Xos, Xos, Xos, Xos, Xos, Xos, Xos, Xos, Xos, Xos, Xos, Xos, Xos, Xos, Xos, Xos, Xos
Xos, Xos, Xos, Xos, Xos, Xos, Xos, Xos, Xoc, Xoc, Cm, Cm^Vm, Cm, Xoc, Xoc, Xoc, Cm^Vm, Cm, Km, Cm, Cm^Vm, Xoc, Xoc, Xoc, Cm, Xoc, Xoc, Xos, Xos, Xos, Xos, Xos, Xos, Xos, Xos, Xos, Xos, Xos, Xos, Xos, Xos, Xos, Xos, Xos, Xos, Xos, Xos, Xos, Xos, Xos
Xos, Xos, Xos, Xos, Xos, Xos, Xos, Xos, Xoc, Xoc, Xoc, Cm, Xoc, Xoc, Cm, Cm, Cm, Km, 1 Km, Km, Cm, Cm, Cm, Xoc, Km, Xoc, Xoc, Xos, Xos, Xos, Xos, Xos, Xos, Xos, Xos, Xos, Xos, Xos, Xos, Xos, Xos, Xos, Xos, Xos, Xos, Xos, Xos, Xos, Xos, Xos
Xos, Xos, Xos, Xos, Xos, Xos, Xos, Xos, Xoc, Xoc, Xoc, Cm, Xoc, Cm, Cm, Cm, Cm, Km, Km, Km, Cm, Cm, Cm, Cm, Cm, Xoc, Xoc, Xos, Xos, Xos, Xos, Xos, Xos, Xos, Xos, Xos, Xos, Xos, Xos, Xos, Xos, Xos, Xos, Xos, Xos, Xos, Xos, Xos, Xos, Xos
Xos, Xos, Xos, Xos, Xos, Xos, Xos, Xos, Xoc, Xoc, Xoc, Cm^Pr|, Xoc, Cm, Cm, Kme, Cm, Cm, Cm, Cm, Cm, Kme, Cm, Cm, Cm, Xoc, Xoc, Xos, Xos, Xos, Xos, Xos, Xos, Xos, Xos, Xos, Xos, Xos, Xos, Xos, Xos, Xos, Xos, Xos, Xos, Xos, Xos, Xos, Xos, Xos
Xos, Xos, Xos, Xos, Xos, Xos, Xos, Xos, Xoc, Xoc, Xoc, Cm, Cm, Cm, Cm, Cm, Cm, Cm, Kme, Cm, Cm, Cm, Cm, Cm, Cm, Xoc, Xos, Xos, Xos, Xos, Xos, Xos, Xos, Xos, Xos, Xos, Xos, Xos, Xos, Xos, Xos, Xos, Xos, Xos, Xos, Xos, Xos, Xos, Xos, Xos
Xos, Xos, Xos, Xos, Xos, Xos, Xos, Xos, Xoc, Xoc, Xoc, Cm, Cm, Cm, Cm, Kme, Cm, Cm, Cm, Cm, Cm, Kme, Cm, Cm, Cm, Xoc, Xos, Xos, Xos, Xos, Xos, Xos, Xos, Xos, Xos, Xos, Xos, Xos, Xos, Xos, Xos, Xos, Xos, Xos, Xos, Xos, Xos, Xos, Xos, Xos
Xos, Xos, Xos, Xos, Xos, Xos, Xos, Xos, Xoc, Xoc, Xoc, Cm, Cm, Cm, Cm, Cm, Cm, Cm, Cm, Cm, Cm, Cm, Cm, Cm, Cm, Xoc, Xos, Xos, Xos, Xos, Xos, Xos, Xos, Xos, Xos, Xos, Xos, Xos, Xos, Xos, Xos, Xos, Xos, Xos, Xos, Xos, Xos, Xos, Xos, Xos
Xos, Xos, Xos, Xos, Xos, Xos, Xos, Xos, Xoc, Xoc, Xoc, Cm^Vm, Cm, Cm, Km, Cm, Cm, Cm, Cm, Cm, Cm, Cm, Km, Cm, Cm^Vm, Xoc, Xoc, Xos, Xos, Xos, Xos, Xos, Xos, Xos, Xos, Xos, Xos, Xos, Xos, Xos, Xos, Xos, Xos, Xos, Xos, Xos, Xos, Xos, Xos, Xos
Xos, Xos, Xos, Xos, Xos, Xos, Xos, Xos, Xoc, Xoc, Xoc, Xoc, Xoc, Cm, Cm, Km, Cm, Cm, Cm, Cm, Cm, Km, Cm, Cm, Xoc, Xoc, Xoc, Xos, Xos, Xos, Xos, Xos, Xos, Xos, Xos, Xos, Xos, Xos, Xos, Xos, Xos, Xos, Xos, Xos, Xos, Xos, Xos, Xos, Md, Xos
Xos, Xos, Xos, Xos, Xos, Xos, Xos, Xos, Xoc, Xoc, Rra, Rra, Rra, Cm, Xoc, Cm, Cm, Cm, Cm, Cm, Cm, Cm, Xoc, Wot, Wo, Xoc, Xoc, Xos, Xos, Xos, Xos, Xos, Xos, Xos, Xos, Xos, Xos, Xos, Xos, Xos, Xos, Xos, Xos, Xos, Xos, Xos, Xos, Xos, Xos, Xos
Xos, Xos, Xos, Xos, Xos, Xos, Xos, Xos, Xoc, Rra, Rra, Rra, Rra, Rra, Rra, Xoc, Cm, Cm, Cm, Cm, Cm, Xoc, Xoc, Wo, Wo, Wog, Xoc, Xos, Xos, Xos, Xos, Xos, Xos, Xos, Xos, Xos, Xos, Xos, Xos, Xos, Xos, Xos, Xos, Xos, Xos, Xos, Xos, Xos, Xos, Xos
Xos, Xos, Xos, Xos, Xos, Xos, Xos, Xos, Xoc, Xoc, Xoc, Rra, Rra, Rra, Xoc, Xoc, Ww, Cm, Cm, Cm, Ww, Xoc, Xoc, Wot, Wog, Wot, Xoc, Xos, Xos, Xos, Xos, Xos, Xos, Xos, Xos, Xos, Xos, Xos, Xos, Xos, Xos, Xos, Xos, Xos, Xos, Xos, Xos, Xos, Xos, Xos
Xos, Xos, Xos, Xos, Xos, Xos, Xos, Xos, Xoc, Xoc, Xoc, Xoc, Xoc, Xoc, Xoc, Ds, Ww, Ww, 2 Ww, Ww, Ww, Ds, Xoc, Xoc, Xoc, Xoc, Xoc, Xoc, Xos, Xos, Xos, Xos, Xos, Xos, Xos, Xos, Xos, Xos, Xos, Xos, Xos, Xos, Xos, Xos, Xos, Xos, Xos, Xos, Xos, Xos
Xos, Xos, Xos, Xos, Xos, Xos, Xos, Xos, Xoc, Xoc, Xoc, Xoc, Xoc, Xoc, Ds, Dd^Do, Ww, Ww, Ww, Ww, Ww, Dd^Do, Ds, Xoc, Xoc, Xoc, Xos, Xos, Xos, Xos, Xos, Xos, Xos, Xos, Xos, Xos, Xos, Xos, Xos, Xos, Xos, Xos, Xos, Xos, Xos, Xos, Xos, Xos, Xos, Xos
Xos, Xos, Xos, Xos, Xos, Xos, Xos, Xos, Xoc, Xoc, Xoc, Xoc, Xoc, Xoc, Ds, Ww, Ww, Ww, Ww, Ww, Ww, Ww, Ds, Xoc, Xoc, Xoc, Xos, Xos, Xos, Xos, Xos, Xos, Xos, Xos, Xos, Xos, Xos, Xos, Xos, Xos, Xos, Xos, Xos, Xos, Xos, Xos, Xos, Xos, Xos, Xos
