Wo, Wo, Wo, Wo, Wo, Wo, Wo, Wo, Wo, Wo, Wo, Wo, Wo, Wo, Wot, Wo, Wot, Wo, Wo, Wo, Wo, Wo, Wo, Wo, Wo, Wo, Wo, Wo, Wo, Wwt, Ds, Ds, Wo, Wo, Wo, Wo, Wo, Wo, Wo, Wo, Wo, Wo, Wo
Wo, Wo, Wo, Wo, Wo, Wo, Wo, Wo, Wo, Wo, Wot, Wo, Wo, Wot, Wo, Wot, Wo, Wo, Wo, Wo, Wot, Wo, Wo, Wo, Wo, Wo, Ww, Wo, Wwt, Wwt, Ds, Ds, Wwrt, Wo, Wo, Wot, Wo, Wo, Wwrt, Wo, Wot, Wo, Wwt
Wo, Wo, Wo, Wo, Wo, Wo, Wwt, Wot, Wo, Wo, Wot, Wo, Wo, Wo, Wo, Wo, Wo, Wo, Wo, Wot, Wo, Wot, Wot, Wot, Wot, Wo, Wwrt, Ww^Vm, Ds^Es, Hd, Wwrt, Ds^Es, Wo, Wo, Cme, Wo, Rb^Es, Wwrt, Wo, Wot, Wwt, Wwrt, Ds
Wo, Wo, Wo, Wo, Ww, Wwt, Ds, Wwrt, Ds^Vm, Wo, Wot, Wot, Wot, Wo, Wo, Wo, Wo, Wo, Wo, Wo, Wo, Wo, Wo, Wo, Wo, Wwrt, Ds, Ds^Es, Hd, Ds, Wo, Wo, Wo, Wwrt, Cme, Ww^Vm, 5 Kme, Cme, Ww, Wwrt, Ds, Ds, Ds
Wo, Wo, Wo, Wo, Rb, Rb^Es, Wwt^Es, Ds, Ds, Wwrt, Wot, Wot, Wot, Wo, Wo, Wo, Wo, Wo, Wot, Wo, Wo, Wo, Wo, Wo, Wo, Wwrt, Ds, Hd, Rb, Ww, Wo, Wo, Wo, Wo, Wo, Cme, Wwrt, Cme, Wwrt, Wwrt, Ds, Hd, Hd
Wo, Wot, Wo, Cme, Rb, Wwt, Ds, Ds^Es, Wwrt, Wwt, Wot, Wot, Wot, Wot, Wot, Wot, Wot, Wo, Wot, Wot, Wo, Wo, Wot, Wot, Wot, Wwt, Wo, Ww^Es, Wo, Wo, Wot, Wo, Wo, Wo, Wo, Wo, Wwt, Wwt, Ds, Ds, Hd, Hd, Hd
Wo, Wo, Wo, 1 Kme, Cme, Cme, Wwt, Ds^Es, Wwrt, Wo, Wo, Wot, Wot, Wot, Wot, Wot, Wo, Wot, Wot, Wo, Wo, Wo, Wo, Wo, Wo, Wot, Wot, Wo, Wot, Wot, Ww, Ww, Ww, Wo, Wwt, Wwt, Ds, Ds, Hd, Hd, Hd, Hd, Hd
Wo, Wot, Wot, Cme, Wo, Wwt, Ds, Ds, Wo, Wo, Wo, Wot, Wot, Wot, Wo, Wo, Wo, Wo, Wot, Wo, Wo, Wo, Wot, Wo, Wo, Wot, Wwrt, Wo, Wo, Wo, Wwt, Wwrt, Wwrt, Wwrt, Wwt, Ds, Hd, Ww^Vm, Hd, Hd, Hd, Ds, Hd
Wo, Wo, Wot, Wo, Wo, Wo, Wo, Wo, Wo, Wo, Wo, Wo, Wwrt, Wo, Wo, Wo, Wo, Wo, Wo, Wot, Wot, Wo, Wot, Wo, Wo, Wot, Wwrt, Wo, Wo, Wwt, Wwrt, Wwrt, Wwt, Wwt, Ds, Wwt, Ds, Ds, Ds, Ds, Ds, Hd, Hd
Wo, Wo, Wo, Wo, Wo, Wo, Wot, Wo, Wo, Wwt, Wwt, Wwt, Wo, Wo, Wo, Wot, Wot, Wo, Wo, Wo, Wot, Wot, Wot, Wo, Wo, Wo, Wwrt, Wo, Wo, Wwt, Wo, Wo, Wwt, Ds, Ds, Hd, Hd, Ds, Wwt, Wwt, Hd, Ds, Hd
Wo, Wo, Wo, Wo, Wot, Wot, Wo, Wo, Wo, Wo, Wo, Wo, Wo, Wo, Wo, Wot, Wot, Wot, Wo, Wo, Wo, Wot, Wo, Wo, Wo, Wo, Wo, Wo, Wot, Wot, Wwrt, Wwt, Ds, Ds, Hd, Ds, Wwrt, Wwt, Ds, Wwrt, Hd, Hd, Ds
Wo, Wo, Wo, Wo, Wot, Wo, Wo, Wo, Wot, Wo, Wo, Wo, Wo, Wo, Wo, Wo, Wo, Wot, Wot, Wo, Wo, Wo, Wo, Wo, Wot, Wot, Wot, Wo, Wot, Wot, Wot, Wwt, Ds, Hd, Hd, Ds, Hd, Hd, Hd, Hd, Ds, Ds, Hd
Wo, Wo, Wot, Wot, Wot, Wo, Wot, Wot, Wot, Wot, Wo, Wo, Ww, Ww, Wwt, Wo, Wo, Wo, Wot, Wot, Wot, Wo, Wo, Wot, Wo, Wo, Wo, Wot, Wot, Wot, Wot, Wwt, Ds, Hd, Dd^Vdt, Hd, Hd, Hd, Hd, Hd, Hd, Hd, Hd
Wo, Wo, Wot, Wot, Wot, Wot, Wot, Wot, Wwt, Wo, Wo, Wo, Ww^Vm, Wwt, Ds, Ww, Wo, Wo, Wot, Wot, Wo, Wo, Wo, Wo, Wo, Wo, Wo, Wot, Wot, Wot, Wwt, Wwt, Wwt, Ds, Hd, Hd, Hd, Hd, Hd, Hd, Hd, Wwt, Hd
Wo, Wo, Wo, Wo, Wo, Wot, Wo, Wo, Wo, Wwt, Wo, Wo, Ds, Ds, Wwf, Ds, Wo, Wo, Wo, Wo, Wo, Wo, Wwrt, Wo, Wwt, Wwt, Wwt, Wwt, Wwt, Wwt, Wwt, Wwt, Wwt, Cm, Cm, Hd, Dd, Dd^Do, Gs, Hd, Hd, Hd, Dd
Wo, Wo, Wo, Wo, Wwt, Ww, Wo, Wo, Wo, Ww, Ww, Wwt, Wwrt, Wwf, Wwt, Ww, Wo, Wo, Wot, Wo, Wo, Wwrt, Wwrt, Wwrt, Wwt, Wwt, Wwt, Ds, Ds, Wwt, Cm, Wwt, Wwt, Wwt, Wwt, Dd, Wwt, Dd, Wwt, Dd, Dd, Dd, Wwt
Wo, Wo, Wo, Ww, Ds, Wwf, Wo, Wo, Wo, Wo, Wo, Wo, Wo, Wwrt, Ww, Wo, Wo, Wot, Wot, Wot, Wo, Wot, Wwrt, Wwt, Wwt, Wwt, Wwt, Ds, Hd, Dd, Dd, Cm, Wwt, Wwt, Wwt, Wwt, Cm, Wwt, Wwt, Wwt, Wwt, Dd, Wwf
Wo, Wo, Wo, Ww, Wwf, Wwrt, Wo, Wo, Wo, Wo, Wo, Wo, Wwrt, Wo, Wo, Wo, Wo, Wo, Wot, Wo, Wo, Wot, Wwrt, Wwt, Wwt, Wwt, Ds, Dd, Dd^Do, Dd, Gs, Ds, Wwt, Wwt, Cm, Wwt, 2 Km, Cm, Wwt, Wwt, Wwt, Wwf, Wwf
Wo, Wo, Wo, Wo, Wo, Wwt, Wo, Wo, Wo, Wo, Wo, Wo, Wo, Wo, Wo, Wo, Wot, Wot, Wot, Wot, Wot, Wot, Wwrt, Wwt, Wwt, Ds, Hd, Md, Md, Gs, Dd, Ds, Wwt, Wwt, Wwrt, Cm, Wwt, Wwf, Wwt, Wwt, Wwt, Wwf, Wwf
Wo, Wo, Wo, Wo, Wo, Wo, Wo, Wo, Wo, Wo, Wo, Wo, Wot, Wo, Wot, Wot, Wot, Wot, Wo, Wo, Wwrt, Wwrt, Wwt, Wwt, Ds, Dd, Md, Md, Md, Dd, Wwt, Dd, Ds, Wwt, Wwt, Wwrt, Wwt, Wwt, Wwf, Wwt, Wwt, Wwt, Wwt
Wo, Wo, Wo, Wo, Wo, Wo, Wo, Wo, Wo, Wo, Wot, Wot, Wo, Wot, Wo, Wot, Wo, Wo, Wo, Wwrt, Wwrt, Wwt^Vm, Wwt, Wwt, Ds, Dd, Md, Md, Hd, Md, Dd, Wwt^Bw|, Wwt, Wwt, Wwrt, Wwrt, Ds, Ds, Wwf, Wwf, Wwf, Wwt, Wwt
Wo, Wo, Wo, Wo, Wo, Wo, Wo, Wo, Wo, Wo, Wo, Wo, Wo, Wo, Wo, Wo, Wo, Wo, Wo, Wo, Wo, Wwt, Wwt, Wwt, Ds, Hd, Md, Md, Hd, Dd, Dd^Do, Dd, Wwt, Wwt, Wwrt, Wwt, Wwt, Ds, Wwf, Wwf, Wwt, Wwt, Wwt
Wot, Wot, Wot, Wo, Wo, Wo, Wo, Wo, Ww, Wo, Ds^Vhs, Wo, Wo, Wo, Wo, Wo, Wo, Wo, Wo, Wo, Wo, Wot, Wwt, Wwt, Dd, Hd, Dd, Hd, Dd, Dd, Dd^Vdt, Dd, Wwt, Wwt, Wwrt, Wwt, Wwt, Wwt, Wwt, Wwt, Wwt, Wwt, Wwt
Wot, Wot, Wot, Wo, Wo, Wo, Wwt, Ww, Ds, Ds, Ds, Wo, Wo, Wo, Cme, Cme, Cme, Wo, Wo, Wot, Wwrt, Wwt, Wwt, Gg, Gg, Dd, Gg, Dd, Gs, Gs, Gs, Ds, Ds, Wwf, Wwt, Wwt, Wwt, Wwt, Wwt, Wwt, Wwt, Wwt, Wwt
Wot, Wo, Wo, Wwrt, Wwrt, Wwrt, Wwt, Ds, Wwf, Wwf, Wo, Wo, Wo, Wo, 4 Kme, Wo, Cme, Wo, Wo, Wo, Wwrt, Wwrt, Wwt, Wwt, Wwt, Gg, Gg, Wwt, Wwt, Gs, Gg, Ds, Ds, Wwt, Wwt, Wwt, Wwt, Wwt, Wwt, Wwt, Wwrt, Wwt, Wwt
Wot, Wo, Wo, Ww, Wo, Wwrt, Wwt, Ds, Ds, Wwf, Ds^Es, Wo, Wo, Wo, Wot, Cme, Wo, Wo, Wo, Wo, Wwrt, Wwt, Wwt, Wwt, Wwt, Gg, Gg, Gs^Ft, Gs^Ft, Wwt^Bw|, Wwt, Gg, Wwt, Wwt, Wwt, Wwt, Wwt, Wwt, Wwt, Wwrt, Wwrt, Wwrt, Wwt
Wot, Wo, Wo, Wo, Wo, Wo, Ww, Wwrt, Wwt^Vm, Ds, Wo, Wo, Wo, Wo, Wot, Wot, Wot, Wo, Wo, Wo, Wo, Wwt, Wwt, Wwt, Wwt, Gg, Gs^Ft, Gs^Ft, Gs^Ft, Gg^Bw|, Gg, Wwt, Gg, Ds, Ds, Wwt, Wwt, Wwt, Wwt, Wwt, Wwrt, Wwt, Wwrt
Wo, Wot, Wot, Wot, Wot, Wo, Wo, Ww, Wo, Wo, Wo, Ds^Es, Ds, Wo, Wot, Wo, Wo, Wot, Wo, Wo, Wo, Wo, Wwt, Wwt, Wwt, Gg, Gs^Ft, Gs^Ft, Gs^Ft, Gs^Bw\, Gg^Bw\, Wwt, Gs, Gs, Ds, Wwt, Wwt^Vm, Wwt, Ww, Wwrt, Wwrt, Wwrt, Wwt
Wo, Wo, Wo, Wot, Wwrt, Wo, Wwt, Wo, Wwt, Wo, Wo, Ds, Wo, Wo, Wot, Wo, Wo, Wo, Wo, Wo, Wwt^Vm, Wwt, Wwt, Wwt, Wwt, Gs^Ft, Gg, Gs^Ft, Gs^Ft, Gs^Ft, Ss^Bw|, Ss, Gs, Gs, Gs^Ft, Wwt, Wwt, Wwt, Wwf, Wwf, Wwt, Wwt, Wwt
Wo, Wo, Wo, Wwt^Vm, Wwt, Wwt, Ds^Es, Wwrt, Wot, Wo, Wo, Wo, Wo, Wot, Wo, Wot, Wot, Wo, Wwrt, Wwrt, Wwt^Vm, Wwt, Wwt, Wwt, Wwt, Gs^Ft, Gg, Gs^Ft, Gs^Ft, Gs^Ft, Wwt^Bw|, Gs^Ft, Gs^Ft, Gs^Ft, Gs^Ft, Ds, Gs, Wwf, Wwf, Wwf, Wwf, Wwt, Wwf
Wo, Wo, Wwrt, Ww, Mm, Hd, Ww^Es, Ww, Wot, Wo, Ds^Es, Wo, Wo, Wot, Wo, Wo, Wo, Wwrt, Wwt, Wwrt, Wwrt, Wwrt, Wwt, Wwt, Ss, Ss, Ss, Ss, Ss, Wwt, Gg^Bw|, Gs^Ft, Gs, Gs^Ft, Ss, Gs^Bw|, Gs^Ft, Gs^Ft, Gs, Wwf, Wwf, Wwf, Wwf
Wo, Wwt, Mm, Mm, Wwrt, Wwt, Wwrt, Ww, Wot, Wo, Wo, Wo, Ds^Ft, Wo, Wwrt, Wo, Wwt, Wwt, Mm, Wwt, Wwt, Wwrt, Wwt, Wwt, Ss, Ss, Ss, Ss, Ss, Ss^Vhs, Ss^Bw\, Ss, Ss, Ss, Ss, Ss^Bw|, Gs^Ft, Gs^Ft, Gs^Ft, Gs, Gs, Ds, Ds
Ww, Wwt, Hd, Wwrt, Wwt^Es, Ww, Wot, Wo, Wo, Wot, Wot, Wo, Ds^Ft, Ds^Vm, Wwrt, Wwrt, Wwt, Mm, Mm, Mm, Wwt, Wwrt, Wwt, Ss, Ss, Ss, Ss, Ss, Ss, Ss, Ss^Bw|, Gs^Ft, Cme, Ss, Ss, Ss^Bw|, Gs, Gs, Gs^Ft, Gs, Ss^Bw/, Gs, Gg
Wo, Wwrt, Hd^Es, Wwrt, Ww, Wot, Wot, Wo, Wo, Wo, Wo, Wo, Wo, Ds^Ft, Wo, Wo, Wo, Wwt, Wwt, Wwt, Wwrt, Wwrt, Wwt, Wwt, Wwt, Ss, Wwt, Ss, Ss, Ss, Ss^Bw|, Gs^Ft, Ss, Ss, Ss^Bw/, Ss^Bw/, Ss, Gs, Ss^Bw/, Ss^Bw/, Ss, Gg, Gs^Ft
Wo, Ww, Ds^Vhs, Ww, Wot, Wot, Wo, Wo, Wo, Wo, Wo, Wo, Wo, Wo, Wo, Wo, Wo, Wwrt, Wwrt, Wwrt, Wwrt, Wwt, Ss, Ss, Ss, Wwt, Ss, Wwt, Ss, Ss, Cme, Uu^Bw\, Ss^Bw/, Ss^Bw|, Ss, Ss, Ss, Ss^Bw/, Ss, Ss, Ss, Gs^Ft, Ss^Vm
Wo, Ww, Wwrt, Ww, Wo, Wo, Wo, Wo, Ww, Ww, Wot, Wot, Wot, Wo, Wot, Wo, Wo, Wwrt, Wo, Wwt, Wwt, Wwt, Wwt, Ss, Ss, Wwt, Ss, Ss, Ss, Gs^Ft, Cm, Cme, Cme, Ss^Bw|, Ss, Ss, Ss, Ss^Bw|, Ss, Ss, Ss^Bw/, Ss^Bw/, Ss^Bw\
Wo, Wo, Ww, Wo, Wo, Wo, Wo, Wwt, Wwf, Wwf^Es, Ww, Wot, Wot, Wot, Wo, Wo, Wo, Wo, Wo, Wwt, Wwt, Wwt, Wwt, Ss, Ss, Wwt, Wwt, Ss, Wwt, Ss, Ss, 3 Km, Cme, Ss^Bw\, Ss^Bw\, Ss, Ss^Bw/, Ss^Bw/, Ss^Bw\, Ss^Bw/, Wwt^Vm, Ss, Ss
Wo, Wo, Wo, Wo, Wo, Wo, Wo, Wot, Ww, Wwf, Wwf, Wot, Wot, Wot, Wo, Wo, Wo, Wo, Wwt, Wwt, Wwt, Wwt, Ss, Ss, Wwt, Ss, Ss, Wwt, Ss, Ss, Ss, Cm, Ss, Ss, Ss, Ss^Bw\, Ss, Ss, Ss, Wwt, Ss, Ss, Gs^Ft
Wo, Wo, Wot, Wo, Wot, Wo, Wo, Wot, Wot, Wwf^Es, Wwt, Wot, Wot, Wot, Wot, Wo, Wo, Wwt, Wwt, Wwt, Wwt, Wwt, Ss, Wwt, Wwt, Wwt, Ss, Ss, Ss, Ss, Wwt, Ss, Ss^Vhs, Ss, Ss, Ss, Ss, Ss, Cme, Ss, Ss, Gs^Ft, Gs^Ft
Wo, Wo, Wot, Wot, Wot, Wo, Wo, Wo, Wo, Ww, Wot, Wot, Wot, Wot, Wot, Wo, Wo, Wo, Wwt, Wwt, Wwt, Wwt, Ss, Ss, Ss, Ss, Ss, Ss, Ss, Wwt, Wwt, Wwt, Ss, Ss, Ss, Ss, Gs^Ft, Cme, Gs^Ft, Ss, Gs^Ft, Gs^Ft, Gs^Ft
Wo, Wot, Wot, Wot, Wo, Wo, Wo, Wo, Wot, Wot, Wot, Wot, Wo, Wot, Wo, Wo, Wo, Wwt, Wwt, Wwt, Wwt, Wwt, Gg, Ss, Ss, Ss, Gs^Ft, Gs^Ft, Gs^Ft, Ss, Gs^Ft, Ss, Ss^Ft, Ss, Ss^Ft, Ss, Gs^Ft, Gs^Ft, Gs^Ft, Gs^Ft, Gs^Ft, Gs^Ft, Gs^Ft
Wo, Wot, Wot, Wo, Wo, Wo, Ww, Ww, Ww, Wot, Wwt, Wo, Wo, Wo, Wo, Wo, Wo, Ww, Wwrt, Wwt, Wwt, Wwt, Gg, Gg, Ss, Gg, Gs^Ft, Gs^Ft, Gs^Ft, Ss, Gs^Ft, Gg, Ss^Ft, Gg, Ss^Ft, Gg, Gs^Ft, Gg, Gs^Ft, Gs^Ft, Ss^Ft, Ss^Ft, Ss^Ft
Wo, Wo, Wot, Wo, Wwf, Wwf, Rb^Es, Rb^Es, Rb, Ww, Wwrt, Wo, Wo, Wo, Ww, Ww, Ww, Wwrt, Wwt, Wwf, Wwrt, Ds, Ss, Ss, Ss, Ss^Ft, Ss^Ft, Gs^Ft, Sm, Ss, Ss, Sm, Ss^Ft, Sm, Ss, Sm, Rb, Gg, Ss^Ft, Ss^Ft, Ss^Ft, Ss^Ft, Ss^Ft
Wo, Wo, Wot, Wwt^Vm, Wwrt, Wwrt, Wwrt, Rb, Rb, Wwf, Wwf, Wo, Wwrt, Ww, Wwrt, Wwf^Es, Wwrt, Wwrt, Wwf^Es, Wwf^Es, Ds, Ds, Ds^Ft, Ss, Ss^Ft, Ss^Ft, Ss^Ft, Rb^Ft, Wwt, Wwt, Ss^Ft, Ss^Ft, Ss^Ft, Ss, Ss, Rb, Sm, Sm^Ft, Sm^Ft, Ss^Ft, Ss^Vhs, Ss^Ft, Sm^Ft
Wot, Wot, Wot, Wot, Wo, Wwrt, Wwrt, Rb^Es, Wwrt, Wwrt, Wwrt, Rb^Es, Ww, Wwf^Es, Ww, Wwf, Wwrt, Rb, Gg, Ds^Ft, Hd^Ft, Ss^Vhs, Gg, Hd, Gg^Ft, Ss^Ft, Gg^Ft, Wwt, Ss, Ss^Ft, Ss^Ft, Ss^Vhs, Ss^Ft, Ss^Ft, Ss, Wwt, Wwt, Sm, Sm^Ft, Sm^Ft, Sm^Ft, Sm^Ft, Sm^Ft
Wot, Wot, Wo, Wo, Wo, Wwrt, Wo, Wo, Wo, Wo, Wo, Wo, Wo, Wwrt, Wo, Wwrt, Wo, Wo, Gg, Hd^Ft, Gg, Gg, Gg, Gg^Ft, Gg^Ft, Gg^Ft, Gg^Ft, Wwt, Rb, Ss^Ft, Ss, Ss^Ft, Ss, Ss, Rb, Rb, Rb, Wwt, Rb, Sm^Ft, Sm^Ft, Sm^Ft, Sm^Ft
Wo, Wot, Wo, Wo, Wo, Wo, Wo, Wo, Wo, Wo, Wo, Wo, Wo, Wo, Wo, Wo, Gg, Gg, Gg, Gg, Gg, Gg, Wo^Ft, Gg^Ft, Wo, Gg^Ft, Gg, Rb, Gg, Gg, Gg, Gg, Gg, Gg, Gg, Rb, Rb, Wwt, Gg, Sm, Sm^Ft, Sm^Ft, Sm
