Wo, Wo, Wo, Wo, Wo, Wo, Wo, Wo, Wo, Wo, Wo, Wo, Wo, Wo, Wo, Wo, Wo, Wo, Wo, Wo, Wo, Wo, Wo, Wo, Wo, Wo, Wo, Wo, Wo, Wo, Wo, Wo, Wo, Wo, Wo, Wo, Wo, Wo, Wo, Wo
Wo, Wo, Wo, Wo, Wo, Wo, Wo, Wo, Wo, Wo, Wo, Wo, Wo, Wo, Wo, Wo, Wo, Wo, Wo, Wo, Wo, Wo, Wo, Wo, Wo, Wo, Wo, Wo, Wo, Wo, Wo, Wo, Wo, Wo, Wo, Wo, Wo, Wo, Wo, Wo
Wo, Wo, Wo, Wo, Wo, Wo, Wo, Wo, Wo, Wo, Wo, Wo, Wo, Wo, Wo, Wo, Wo, Wo, Wo, Wo, Wog, Wo, Wog, Wo, Wo, Wo, Wo, Wo, Wo, Wo, Wo, Wo, Wo, Wo, Wo, Wo, Wo, Wo, Wo, Wo
Wo, Wo, Wo, Wo, Wo, Wo, Wo, Wo, Wo, Wo, Wo, Wo, Wo, Wo, Wo, Wo, Wog, Wo, Wog, Wog, Wog, Wog, Wog, Wog, Wog, Wo, Wog, Wo, Wog, Wog, Wo, Wo, Wo, Wo, Wo, Wo, Wo, Wo, Wo, Wo
Wo, Wo, Wo, Wo, Wo, Wo, Wo, Wo, Wo, Wo, Wo, Wo, Wo, Wo, Wog, Wog, Wog, Wog, Wog, Wog, Wog, Wog, Wog, Wog, Wog, Wog, Wog, Wog, Wog, Wog, Wog, Wog, Wog, Wo, Wo, Wo, Wo, Wo, Wo, Wo
Wo, Wo, Wo, Wo, Wo, Wo, Wo, Wo, Wo, Wo, Wo, Wo, Wo, Wog, Wog, Wog, Wog, Wog, Wog, Wog, Wog, Wog, Wog, Wog, Wog, Wog, Wog, Wog, Wog, Wog, Wog, Wog, Cme, Cme, Cme, Wo, Wo, Wo, Wo, Wo
Wo, Wo, Wo, Wo, Wo, Wo, Wog, Wo, Wog, Wog, Wog, Wo, Wog, Wog, Wog, Wog, Wog, Wog, Wog, Wwg, Wog, Wog, Wog, Wog, Wog, Wog, Wog, Wog, Wog, Wog, Wog, Wog, Cme, 1 Kme, Cme, Wo, Wo, Wo, Wo, Wo
Wo, Wo, Wo, Wo, Wo, Wog, Wog, Wog, Wog, Wog, Wog, Wog, Wog, Wog, Wog, Wog, Wog, Wog, Wog, Wwg, Wwg, Wwg, Wog, Wog, Wwg, Wwg, Wog, Wog, Wog, Wog, Wwg, Wwg, Wwg, Cme, Wog, Wo, Wo, Wo, Wo, Wo
Wo, Wo, Wo, Wo, Wo, Wo, Wog, Wog, Wog, Wog, Wog, Wog, Wog, Wog, Wog, Wog, Wog, Wog, Wog, Wog, Wwg, Wwg, Wwg, Wwg, Wwg, Wwg, Wwg, Wwg, Wwg, Wwg, Wwg, Wwg, Wwg, Wog, Wog, Wo, Wo, Wo, Wo, Wo
Wo, Wo, Wo, Wo, Wo, Wog, Wog, Wog, Wog, Wog, Wog, Wwrg, Wwrg, Wog, Wog, Wog, Wog, Wog, Wog, Wog, Wwrg, Wwg, Wwg, Dd^Ftd, Ds, Ds^Ftr, Wwg, Wwg, Wwg, Wwg, Wwg, Wwg, Wog, Wog, Wo, Wo, Wo, Wo, Wo, Wo
Wo, Wo, Wo, Wo, Wog, Wog, Wog, Wog, Wog, Wog, Wwrg, Wo^Vm, Wog, Wog, Wog, Wog, Wog, Wog, Wwg, Wwg, Wwrg, Wwg, Ds, Gll^Ftr, Dd^Ftd, Dd^Ftd, Wwg, Wwg, Wwg, Wwg, Wog, Wog, Wog, Wog, Wo, Wo, Wo, Wo, Wo, Wo
Wog, Wog, Wog, Wog, Wog, Wog, Wog, Wog, Wog, Wog, Wog, Wog, Wog, Wog, Wog, Wwg, Wog, Wwg, Wwg, Wwrg, Wwg, Ds, Ds^Ftr, Mm^Xm, Gll^Ftr, Dd^Ftd, Ds, Wwg, Wwg, Wwg, Wog, Wog, Wog, Wog, Wog, Wog, Wog, Wo, Wo, Wo
Wog, Wog, Wog, Wog, Wog, Wog, Wog, Wog, Wog, Wog, Wog, Wog, Wwg, Wwg, Wwg, Wwg, Wwg, Wwg, Wwg, Wwg, Dd^Ftd, Chs, Dd^Ftd, Dd^Dc, Ds^Ftr, Wwg, Wwg, Wwg, Wwg, Wog, Wog, Wog, Wog, Wog, Wog, Wog, Wog, Wo, Wo, Wo
Wog, Wog, Wog, Wog, Wog, Wog, Wog, Wog, Wog, Wog, Wwg, Wwg, Wwg, Wwg, Wwg, Wwg, Ds, Dd^Ftd, Ds, Ds, Dd^Ftd, Ds, Dd^Ftd, Wwg, Wwg, Wwg, Wwrg, Ww^Vm, Wog, Wog, Wog, Wog, Wog, Wog, Wog, Wog, Wog, Wog, Wo, Wo
Wog, Wog, Wog, Wog, Wog, Wog, Wwg, Wwg, Wwg, Wwg, Wwg, Ds, Wwg, Wwg, Wwg, Dd^Ftd, Gll^Ftr, Ss^Vhs, Gll^Ftr, Mm, Gll^Ftr, Ss, Ds^Ftr, Wwg, Wwg, Wwg, Wwg, Wwg, Wog, Wwg, Wog, Wog, Wog, Wog, Wwrg, Wog, Wog, Wog, Wo, Wo
Wog, Wog, Wog, Wog, Wog, Wog, Wog, Wwg, Wwg, Ds, Wwg, Gll^Ftr, Dd^Dc, Dd^Ftd, Wwg, Mm, Mm, Mm, Gll^Ftr, Qxu, Dd^Ftd, Dd^Ftd, Dd^Ftd, Mm, Wwg, Dd^Ftd, Wwg, Wwg, Wwrg, Wog, Wwg, Wog, Wog, Wwrg, Wwrg, Wog, Wog, Wog, Wo, Wo
Wog, Wog, Wog, Wog, Wog, Wwg, Wwg, Wwg, Dd^Ftd, Dd^Ftd, Ww^Vm, Mm, Gll^Ftr, Wwg, Ds^Ftr, Gll^Ftr, Mm, Ds^Ftr, Dd^Ftd, Qxu, Qxu, Wwg, Mm, Mm^Xm, Dd^Ftd, Gll^Ftr, Ds, Wwg, Wwg, Wwg, Wog, Wog, Wog, Wog, Wog, Wog, Wog, Wo, Wo, Wo
Wog, Wog, Wog, Wog, Wog, Wwg, Wwg, Wwg, Ds, Dd^Ftd, Gll^Ftr, Dd^Ftd, Dd^Ftd, Wwg, Dd^Ftd, Wwg, Dd^Ftd, Ds^Ftr, Ds^Ftr, Dd^Ftd, Wwg, Wwg, Dd^Dc, Ds^Ftr, Mm, Gll^Ftr, Ds^Ftr, Ds^Ftr, Wwg, Wwg, Wwg, Wwg, Wwg, Wog, Wog, Wog, Wo, Wo, Wo, Wo
Wog, Wog, Wog, Wog, Wog, Wog, Wwg, Wwg, Wwg, Wwg, Ds^Ftd, Sm, Wwf, Wwg, Wwg, Wwg, Wwg, Wwg, Ds, Wwf, Sm, Wwg, Wwg, Ds, Gll^Ftr, Gll^Ftr, Dd^Ftd, Mm, Dd^Ftd, Dd^Dc, Wwg, Wwg, Wwg, Wog, Wog, Wog, Wog, Wo, Wo, Wo
Wog, Wog, Wog, Wog, Wog, Wog, Wog, Wwg, Wwg, Wwg, Wwg, Sm, Wwf, Wwg, Wwg, Wwg, Sm, Wwg, Wwg, Wwf, Wwf, Wwg, Wwg, Ss, Ds^Ftr, Gll^Ftr, Ss, Ss, Gll^Ftr, Wwg, Wwg, Wwg, Wog, Wog, Wog, Wog, Wog, Wo, Wo, Wo
Wog, Wog, Wog, Wog, Wwg^Vm, Wog, Wog, Wog, Wwg, Wwg, Chw, Sm, Sm, Wwg, Wwg, Sm, Sm, Cm, Sm, Sm, Wwf, Wwg, Wwg, Wwg, Ss, Qxu, Ss, Mm^Xm, Dd^Ftd, Ds, Wwg, Wwg, Wog, Wog, Wog, Wog, Wog, Wo, Wo, Wo
Wog, Wog, Wog, Wog, Wog, Wwrg, Wog, Wog, Wwg, Wwg, 3 Km^Dr, Wwf, Sm, Sm, Sm, Cm, Cm^Dr, Cm, Cm, Cm^Dr, Wwf, Sm, Wwf, Wwg, Dd^Ftd, Ss, Ss^Vm, Gll^Ftr, Gll^Ftr, Wwg, Wwg, Wwg, Wog, Wog, Wog, Wog, Wog, Wo, Wo, Wo
Wog, Wog, Wog, Wog, Wog, Wog, Wog, Wog, Wwg, Chw, Wwg, Chw, Wwf, Sm, Sm, Wwf, Cm, 2 Km, Cm, Wwf, Wwf, Wwf, Wwf, Wwf, Wwf, Gll^Ftr, Ss, Gll^Ftr, Dd^Ftd, Wwg, Wwg, Wwg, Wog, Wog, Wog, Wog, Wog, Wog, Wo, Wo
Wog, Wog, Wog, Wog, Wog, Wwg, Wwrg, Wwg, Wwg, Wwg, Wwg, Wwg, Wwg, Sm, Sm, Cm, Wwf, Wwf^Dr, Sm, Cm, Wwg, Wwg, Wwg, Sm, Ss, Ds^Ftr, Gll^Ftr, Dd^Ftd, Ds, Ds^Ftr, Wwg, Wwg, Wwg, Wog, Wog, Wog, Wog, Wog, Wo, Wo
Wog, Wog, Wog, Wwg, Wwg, Wwg, Wwrg, Md, Ds, Dd^Ftd, Wwg, Wwg, Wwg, Wwg, Wwg, Sm, Wwf, Wwf, Sm, Sm, Wwrg, Wwg, Wwg, Wwg, Ds, Gll^Ftr, Gll^Ftr, Dd^Ftd, Ds^Ftr, Ds, Wwg, Wwg, Wwg, Wwg, Wog, Wog, Wog, Wog, Wog, Wo
Wog, Wog, Wog, Wog, Wog, Wwg, Ds, Md^Ftd, Md^Ftd, Md, Ds, Dd^Ftd, Wwg, Wwg, Wwg, Wwg, Wwf, Wwf, Wwrg, Wwrg, Wwrg, Wwrg, Wwrg, Cm, Dd^Ftd, Ds, Dd^Dc, Wwg, Wwg, Wwg, Wwg, Wog, Wwg, Wog, Wog, Wog, Wog, Wog, Wog, Wo
Wog, Wog, Wog, Wog, Wwg, Wwg, Dd^Ftd, Dd^Dc, Dd^Ftd, Md^Ftd, Md, Md^Ftd, Ww^Vm, Ds, Ds, Ds, Wwf, Wwg, Wwg, Wwg, Wwg, Wwg, Wwg, Wwg, Wwg, Wwg, Wwg, Wwg, Wwg, Wwg, Wog, Wog, Wwg, Wog, Wog, Wog, Wog, Wog, Wo, Wo
Wog, Wog, Wog, Wog, Wwg, Wwg, Wwg, Wwg, Wwg, Dd^Ftd, Md, Md^Ftd, Md^Ftd, Md, Dd^Dc, Cm, Wwg, Wwg, Wwg, Wog, Wog, Wog, Wog, Wog, Wwg, Wwg, Wwg, Wog, Wog, Wog, Wog, Wog, Wog, Wog, Wog, Wog, Wog, Wog, Wog, Wo
Wog, Wog, Wog, Wog, Wog, Wog, Wog, Wwg, Wwg, Wwg, Ds, Dd^Ftd, Md^Ftd, Dd^Ftd, Md^Ftd, Wwg, Wwg, Wog, Wog, Wog, Wog, Wog, Wog, Wog, Wog, Wog, Wog, Wog, Wog, Wog, Wog, Wog, Wog, Wog, Wog, Wog, Wog, Wog, Wog, Wo
Wog, Wog, Wog, Wog, Wog, Wog, Wog, Wog, Wwg, Wwg, Wwg, Wwg, Wwg, Ds, Ds, Wwrg, Wwg, Wog, Wog, Wog, Wog, Wog, Wog, Wog, Wog, Wog, Wog, Wog, Wog, Wog, Wog, Wog, Wog, Wog, Wog, Wog, Wo, Wo, Wo, Wo
Wo, Wo, Wog, Wog, Wog, Wog, Wog, Wog, Wog, Wog, Wwg, Wog, Wwg, Wwg, Wwg, Wwg, Wwrg, Wog, Wog, Wog, Wog, Wog, Wog, Wog, Wog, Wog, Wog, Wog, Wog, Wog, Wog, Wo, Wo, Wo, Wo, Wo, Wo, Wo, Wo, Wo
Wo, Wo, Wog, Wog, Wog, Wog, Wog, Wog, Wog, Wog, Wog, Wog, Wwg, Wwg, Wwg, Wwrg, Wog, Wog, Wog, Wog, Wog, Wog, Wog, Wog, Wog, Wog, Wog, Wog, Wog, Wog, Wog, Wo, Wo, Ww^Vm, Wo, Wo, Wo, Wo, Wo, Wo
Wo, Wo, Wo, Wog, Wog, Wog, Wog, Wog, Wog, Wog, Wog, Wog, Wog, Wog, Wog, Wog, Wog, Wog, Wog, Wog, Wog, Wog, Wog, Wog, Wog, Wog, Wog, Wog, Wog, Wog, Wo, Wo, Wo, Wo, Wo, Wo, Wo, Wo, Wo, Wo
Wo, Wo, Wo, Wo, Wo, Wo, Wo, Wo, Wo, Wog, Wog, Wog, Wog, Wog, Wog, Wog, Wog, Wog, Wog, Wog, Wog, Wog, Wog, Wog, Wog, Wog, Wog, Wog, Wog, Wog, Wo, Wo, Wo, Wo, Wo, Wo, Wo, Wo, Wo, Wo
Wo, Wo, Wo, Wo, Wo, Wo, Wo, Wo, Wo, Wo, Wo, Wog, Wog, Wog, Wog, Wog, Wog, Wog, Wog, Wog, Wo, Wog, Wo, Wog, Wo, Wo, Wo, Wog, Wog, Wog, Wo, Wo, Wo, Wo, Wo, Wo, Wo, Wo, Wo, Wo
