Wo, Wo, Wo, Wo, Wo, Wo, Wot, Wo, Wo, Wo, Wo, Wo, Wo, Wo, Wo, Wo, Wo, Wo, Wo, Wot, Wot, Wot, Wot, Wo, Wo, Wo, Wo, Wo, Wo, Wo, Wo, Wo, Wo, Wo, Wo, Wo, Wo, Wo, Wo, Wo, Wo
Wo, Wo, Wo, Wo, Wo, Wo, Wot, Wot, Wot, Wot, Wot, Wo, Wot, Wo, Wo, Wo, Wo, Wo, Wo, Wo, Wo, Wo, Wo, Wo, Wo, Wo, Wo, Wo, Wo, Wo, Wo, Wo, Wo, Wo, Wo, Wo, Wo, Wo, Wo, Wo, Wo
Wo, Wo, Wo, Wo, Wo, Wo, Wo, Wo, Wo, Wot, Wot, Wot, Wo, Wot, Wo, Wo, Wo, Wo, Wo, Wo, Wo, Wo, Wo, Wo, Wo, Wo, Wo, Wot, Wot, Wot, Wot, Wo, Wo, Wo, Wo, Wo, Wot, Wo, Wo, Wo, Wo
Wo, Wo, Wo, Wo, Wo, Wo, Wo, Wo, Wo, Wo, Wo, Wot, Wo, Wo, Wo, Wo, Wo, Wo, Wo, Wo, Wo, Wo, Wo, Wo, Wo, Wo, Wo, Wot, Wot, Wot, Wot, Wo, Wo, Wo, Wot, Wot, Wo, Wo, Wo, Wo, Wo
Wo, Wo, Wo, Wo, Wot, Wo, Ww, Ww, Ww, Wo, Wo, Wo, Wo, Wo, Wo, Wo, Wo, Wo, Wo, Wo, Wo, Wo, Wo, Wo, Wo, Wo, Wo, Wo, Wo, Wo, Wo, Wo, Wo, Wo, Wo, Wo, Wo, Wo, Wo, Wo, Wo
Wo, Wo, Wo, Wo, Wot, Ww, Ww, Ds, Ds^Ftd, Ww, 1 Ww, Wo, Wo, Wo, Wo, Wo, Wo, Wo, Wo, Wo, Wo, Wo, Wo, Wo, Wot, Wo, Wot, Wo, Wo, Wo, Wo, Wo, Wo, Wo, Wo, Wo, Wo, Wo, Wo, Wo, Wo
Wo, Wo, Wot, Wot, Ww, Ww, Gg, Gg, Gg^Ftd, Ds, Ww^Bw/, Ww, Ww, Wo, Wo, Wo, Wo, Wo, Wo, Wo, Wo, Wo, Wo, Wo, Wo, Wot, Wot, Wot, Wot, Wo, Wot, Wo, Wot, Wo, Wo, Wo, Wot, Wo, Wo, Wo, Wo
Wo, Wo, Wot, Wot, Ww, Ds, Gg^Ftd, Gs^Fds, Gg^Vct, Ket, Ce, Ds, Ds, Ww, Wot, Wot, Wot, Wo, Wot, Wo, Wo, Wo, Wo, Wo, Wo, Wo, Wot, Wot, Wot, Wot, Wot, Wot, Wot, Wot, Wot, Wot, Wot, Wo, Wo, Wo, Wo
Wo, Wo, Wot, Ww, Ds, Ds^Ftd, Gg, Mm, Mm, Gg^Fms, Ds, Ce, Ww^Bw/, 2 Ww, Wot, Wot, Wot, Wot, Wot, Wot, Wo, Wo, Wo, Wo, Wo, Wo, Wo, Wot, Ww, Ww, Ww, Wot, Wot, Wot, Wot, Wot, Wot, Wot, Wot, Wo, Wo
Wo, Wo, Wot, Ww, Ww, Ww, Ds, Gg^Fms, Mm, Gg^Vct, Ce, Ke, Ww, Wwr, Ww, Wot, Ww, Wot, Wot, Wot, Wot, Wo, Wo, Wo, Wo, Wo, Wot, Wot, Wot, Ww, Ww, Wwr, Wwr, Wot, Wot, Wot, Wot, Wot, Wot, Wo, Wo
Wo, Wot, Wot, Wot, Ww, Ww, Ds^Ftd, Gg, Ds, Ds^Fms, Ds, Ds, Wwr, Ww, Ds, Ww, Ww, Ww, Wot, Wot, Wot, Wo, Wo, Wo, Wo, Wo, Wot, Wot, Wot, Wot, Ww, Dd^Ftd, Wwr, Ww, Ww, Ww, Wot, Wot, Wot, Wot, Wo
Wot, Wot, Wot, Wot, Ww, Ds, Ds, Dd^Do, Ds^Ftd, Gs^Fds, Gg, Gg^Ftd, Ww, Wwr, Ds^Ftd, Dd^Dc, Ds, Ww, Ww, Wot, Wot, Wot, Wot, Wot, Wo, Wo, Wot, Wot, Wot, Wot, Ww, Gg, Mm, Ds, Dd^Ftd, Dd^Ftd, Ds, Wot, Wot, Wot, Wo
Wot, Wot, Wot, Ww, Ww, Ds, Ww, Ww, Ds, Ds, Ww, Ds, Ww, Ww, Wot, Ww, Ww, Ww, Ww, Wot, Wot, Wot, Wot, Wot, Wot, Wot, Wot, Wot, Wot, Wot, Ww, Dd^Ftd, Hhd, Mm, Mm, Gg, Dd^Dc, Ww, Wot, Wot, Wot
Wot, Wot, Wot, Wot, Wot, Ww, Ww, Ww, Ww, Ww, Ww, Ww, Wot, Wot, Wot, Wot, Wot, Wot, Wot, Ww, Wot, Wot, Wot, Wot, Wot, Wot, Wot, Wot, Wot, Ww, Wwr, Ww, Mm, Mm, Mm, Hh^Fds, Gg, Ds, Ww, Wot, Wot
Wo, Wo, Wo, Wot, Wot, Wot, Wot, Ww, Wot, Ww, Wot, Wot, Wo, Wot, Wot, Wot, Wot, Wot, Wot, Ww, Ww, Wot, Wot, Wot, Wot, Wot, Wot, Wot, Ww, Ww, Ww, Wwr, Mm, Mm, Mv, Ds^Ftp, Ds, Wwr, Wwr, Wot, Wot
Wo, Wo, Wo, Wo, Wo, Wot, Wo, Wot, Wot, Wot, Wot, Wot, Wo, Wo, Wo, Wo, Wo, Wot, Wot, Wot, Ww, Wot, Ww, Ww, Ww, Wot, Wot, Wot, Ww, Ww, Wwr, Wwr, Ds^Ftp, Mm, Mm, Mm, Ww^Vm, Ww, Wwr, Wot, Wot
Wo, Wo, Wot, Wo, Wo, Wo, Wo, Wo, Wo, Wot, Wot, Wot, Wo, Wo, Wo, Wo, Wo, Wo, Wo, Wot, Wot, Ww, Wot, Wot, Wwr, Wot, Wot, Ww, Wot, Ww, Ww, Wwr, Dd^Do, Mm, Mm, Mm, Mm, Wwr, Wwr, Ww, Ww
Wo, Wo, Wo, Wot, Wo, Wo, Wo, Wo, Wo, Wot, Wot, Wot, Wot, Wo, Wo, Wo, Wo, Wo, Wo, Wot, Wot, Wot, Wot, Wot, Wot, Wwr, Ww, Ww, Ww, Wot, Wot, Wwr, Wwr, Gg^Fms, Hh, Mm, Mm, Mm, Mm, Ds, Dd^Dc
Wo, Wo, Wo, Wo, Wo, Wo, Wo, Wo, Wot, Wot, Wot, Wot, Wot, Wot, Wot, Wot, Wot, Wot, Wot, Wo, Wot, Wot, Wot, Wot, Wot, Ds, Wwrt^Vm, Ww, Ww, Wot, Wot, Wot, Ww, Dd^Dc, Ds^Ftp, Hhd^Fms, Hhd^Ftp, Mm, Mm, Mm, Ds^Ftp
Wot, Wo, Wo, Wo, Wo, Wo, Wo, Wot, Wot, Wot, Wot, Wot, Wot, Wot, Wot, Wot, Ww, Ww, Wot, Wot, Wot, Wot, Wot, Wot, Ww, Ds, Ds, Wwt, Ww, Wot, Wot, Ww, Ww, Ds, Ww, Gg^Ftp, Gg, Gs^Fms, Gg^Ftp, Mm, Mm
Wot, Wo, Wo, Wo, Wo, Wo, Wo, Wot, Wot, Ww, Ww, Ww, Ww, Ww, Ww, Wot, Ww, Ww, Ww, Wot, Ww, Wot, Wot, Ww, Wot, Wot, Ww, Wwr, Wwr, Ww, Ww, Ww, Wot, Ww, Ww, Ds, Ds, Wwr, Wwr, Mm, Mm
Wot, Wot, Wo, Wo, Wo, Wo, Wot, Wot, Ww, Ww, Wwr, Wwr, Ds, Ww, Gs^Ftp, Ww, Dd^Ftd, Ww, Dd^Ftd, Ww, Ww, Ww, Ww, Ww, Wot, Wot, Ww, Wot, Wot, Ww, Ww, Wot, Wot, Wot, Wot, Ww, Ww, Ww, Ww, Ds, Ds^Ftp
Wot, Wo, Wo, Wo, Wo, Wo, Wot, Wot, Wot, Ww, Wwr, Wwr, Ds, Gs^Ftp, Md^Xm, Md^Xm, Md^Xm, Gs^Ftp, Xu, Md^Xm, Xu, Wwt, Wwt, Ww, Wot, Ww, Wot, Wot, Wot, Wot, Wot, Wot, Wot, Wot, Wot, Wot, Wot, Wot, Wot, Ww, Ww
Wot, Wot, Wo, Wo, Wo, Wo, Wot, Wot, Wot, Wot, Ww, Wwt, Wwt, Md^Xm, Ql, Ql, Xu, Xu, Wog, Xu, Wog, Wwrt, Xu, Ww, Ds, Ww, Wot, Wot, Wot, Wot, Wot, Wot, Wot, Wot, Wot, Wot, Wo, Wot, Wo, Wot, Wot
Wot, Wot, Wot, Wo, Wo, Wo, Wot, Wot, Wot, Wot, Ww, Ww, Ds, Xu, Xu, Xu, Uu, Ww, Xu, Wog, Wog, Xu, Xu, Ds^Ftp, Dd^Ftd, Ww, Ww, Wot, Wot, Wot, Ww, Wot, Wot, Wot, Wot, Wot, Wot, Wo, Wo, Wo, Wo
Wo, Wot, Wo, Wo, Wo, Wot, Wot, Wot, Ww, Ww, Ww, Wwt, Ds, Dd^Dc, Ww, Wog, Wog, Wog, Cme, Xu, Wog, Wog, Xu, Md^Xm, Mm, Ds^Ftp, Ww, Wot, Ww, Ww, Ww, Ww, Wot, Wot, Wot, Ww, Wot, Wot, Wot, Wo, Wo
Wo, Wo, Wo, Wo, Wo, Wo, Wot, Wot, Ww, Ww, Ds^Ftp, Xu, Xu, Xu, Wog, Ww^Vm, Cme, Uu, 3 Kme, Xu, Uu, Wog, Ql, Xu, Md^Xm, Dd^Ftd, Ww, Ww, Wot, Wot, Wot, Ww, Wwr, Wot, Wot, Ww, Ww^Vm, Wot, Wot, Wo, Wo
Wo, Wo, Wo, Wo, Wo, Wot, Wot, Ww, Ww, Wwr, Ww, Md^Xm, Dd^Do, Wog, Xu, Wog, Uu, Cme, Uu, Cme, Wwrg, Uu^Vu, Xu, Ql, Dd^Ftd, Ww, Wot, Wot, Wo, Wo, Wo, Wot, Wwr, Wot, Wot, Wot, Wot, Wot, Wot, Wo, Wo
Wo, Wo, Wo, Wo, Wo, Wot, Wot, Wot, Wot, Wot, Ww, Ds, Ds, Xu, Xu, Ql, Ql, Wwrg, Wwg, Cme, Wwg, Wwg, Xu, Md^Xm, Ds^Ftp, Ww, Wot, Wo, Wo, Wo, Wo, Wot, Wot, Wwr, Wot, Wot, Wot, Wot, Wo, Wo, Wo
Wot, Wot, Wot, Wot, Wwt, Wwt^Vm, Wot, Wot, Wot, Wot, Wot, Ww, Ww, Md^Xm, Md^Xm, Qlf, Xu, Uu^Vu, Wwg, Uu, Wwg, Wwrg, Ww, Ww, Ww, Ww, Wot, Wo, Wo, Wo, Wot, Wot, Wot, Wwr, Wwr, Wot, Wot, Wo, Wo, Wo, Wo
Ww, Wot, Wot, Wot, Wot, Wot, Wot, Wot, Wot, Wot, Ww, Ww, Ww, Gs^Ftp, Mm, Qlf, Xu, Wwg, Wwrg, Xu, Xu, Xu, Ds, Ww, Wot, Wot, Wot, Wot, Wot, Wot, Wot, Wot, Wot, Wot, Ww, Wot, Wot, Wo, Wot, Wo, Wo
Ww, Ww, Ww, Wot, Wot, Wot, Wot, Wot, Ww, Wot, Ww, Ww, Ww, Ww, Gs^Ftp, Md^Xm, Xu, Wot, Wot, Wot, Ww, Gs^Ftp, Ds, Ww, Wot, Wot, Wot, Wot, Ww, Ww, Ww, Wot, Ww, Ww, Ww, Wot, Wot, Wot, Wot, Wot, Wot
Ds, Ww, Ww, Wot, Wot, Wot, Wot, Wot, Ww, Ww, Ww, Ww, Wot, Ww, Ww, Ww, Ww, Wot, Wot, Ww, Ww, Ds, Ww, Ww, Wot, Wot, Wot, Ww, Ww, Ww, Ww, Ww, Ds, Ww, Ww, Wot, Ww, Wot, Ww, Wot, Ww
Mm, Ds, Ww, Ww, Ww, Wot, Ww, Wot, Ww, Ww, Ww, Ww^Vm, Wot, Wot, Wot, Wot, Ww, Ww, Wot, Wot, Wot, Ww, Ww, Wot, Wot, Wot, Wot, Ww, Ds, Ds, Hhd, Ww, Dd^Dc, Ds, Hhd, Ww, Wwr, Wwr, Ww, Ww, Ww
Mm, Dd^Ftd, Ds, Ww, Mv, Ww, Ds, Ww, Dd^Dc, Ww, Ww, Wot, Wot, Wot, Ww, Ww, Wot, Wot, Wot, Wot, Wot, Wot, Ww, Ww, Wot, Wot, Wot, Ww, Mm, Hhd, Ql, Hhd^Vu, Ql, Ql, Ds, Wwr, Ww, Ww, Wot, Wot, Wot
Ds, Mm, Mm, Mm, Mm, Mm, Mm, Mm, Mm, Ww, Wwr, Wot, Wot, Wot, Ww, Ww, Wot, Wot, Wot, Wot, Wot, Wot, Wot, Ww, Ww, Wot, Ww, Ww, Ds, Ql, Ql, Ql, Ql, Ds, Mm, Ww, Ww, Wot, Wot, Wot, Wot
Ds, Dd^Dc, Dd^Do, Gg^Fms, Hh, Gs^Ftp, Ds, Dd^Do, Ww, Wwr, Wwr, Wwr, Ww, Ww, Wot, Wot, Wot, Wot, Wot, Wot, Wot, Wot, Wot, Wot, Wot, Wwr, Ww, Dd^Dc, Mm, Mv, Mm, Ql, Mv, Mm, Mm, Ww, Ww, Wot, Wot, Wot, Wot
Ww, Ww, Ww, Ww, Ww, Ww, Ww, Ww, Wot, Ww, Wot, Wwr, Wot, Wot, Wo, Wot, Wo, Wot, Wot, Wot, Wot, Wot, Wot, Wot, Wot, Ww, Ww, Hhd, Mm, Mm, Mm, Mm, Mm, Mm, Mm, Ww, Wot, Wot, Ww, Ww, Ww
Wo, Ww, Wot, Ww, Ww, Ww, Wot, Wot, Wo, Wot, Wot, Wot, Wot, Wo, Wo, Wo, Wo, Wo, Wot, Wot, Ww, Wot, Wot, Wot, Ww, Wwr, Ww, Ww, Mm, Mm, Mv, Mm, Mm, Mm, Hhd, Ww, Ww, Ww, Dd^Ftd, Dd^Do, Dd^Ftd
Wo, Wot, Wot, Wot, Wot, Wot, Wot, Wo, Wo, Wo, Wo, Wo, Wo, Wo, Wo, Wo, Wo, Wo, Ww, Ww, Ww, Ww, Wwr, Wwr, Wwr, Ww, Wo, Ww, Mm, Mm, Mm, Mm, Ww, Hhd, Ww, Ww, Ww, Ds, Dd^Ftd, Mm, Dd^Ftd
Wo, Wo, Wo, Wot, Wo, Wot, Wo, Wo, Wo, Wo, Wo, Wo, Wo, Wo, Wot, Wot, Wo, Wo, Wo, Ww, Wo, Ww, Ww, Wwr, Wo, Wo, Wo, Ww, Ww, Ww, Ww, Ww, Ww, Ww, Ww, Ww, Ww, Ds, Ww, Dd^Dc, Ww
Wo, Wo, Wo, Wo, Wo, Wo, Wo, Wo, Wo, Wo, Wot, Wo, Wot, Wot, Wot, Wot, Wot, Wo, Wo, Wo, Wo, Wo, Wo, Wo, Wo, Wo, Wo, Wo, Wo, Ww, Wwr, Wwr, Wo, Wo, Wo, Wo, Wo, Ww, Wo, Ww, Wo
Wo, Wo, Wo, Wo, Wo, Wo, Wo, Wo, Wo, Wo, Wo, Wot, Wo, Wo, Wo, Wot, Wo, Wo, Wo, Wo, Wo, Wo, Wo, Wo, Wot, Wo, Wo, Wo, Wo, Wo, Wo, Wo, Wo, Wo, Wo, Wo, Wo, Wo, Wo, Wo, Wo
Wo, Wo, Wo, Wo, Wot, Wo, Wo, Wo, Wo, Wo, Wo, Wo, Wo, Wo, Wo, Wo, Wo, Wo, Wo, Wo, Wo, Wo, Wo, Wot, Wot, Wot, Wo, Wo, Wo, Wo, Wo, Wo, Wo, Wo, Wo, Wo, Wot, Wo, Wo, Wo, Wo
Wo, Wo, Wot, Wot, Wot, Wot, Wo, Wo, Wo, Wo, Wo, Wo, Wo, Wo, Wo, Wo, Wo, Wo, Wo, Wo, Wo, Wo, Wo, Wo, Wot, Wot, Wot, Wo, Wo, Wo, Wo, Wo, Wo, Wo, Wot, Wot, Wot, Wot, Wo, Wo, Wo
Wo, Wo, Wo, Wot, Wo, Wot, Wot, Wo, Wo, Wo, Wo, Wo, Wo, Wo, Wo, Wo, Wo, Wo, Wo, Wo, Wo, Wo, Wo, Wo, Wo, Wo, Wo, Wot, Wot, Wo, Wo, Wo, Wo, Wo, Wo, Wo, Wo, Wo, Wo, Wo, Wo
Wo, Wo, Wo, Wo, Wo, Wo, Wo, Wo, Wo, Wo, Wo, Wo, Wo, Wo, Wo, Wo, Wo, Wo, Wo, Wo, Wo, Wo, Wo, Wo, Wo, Wo, Wo, Wot, Wot, Wo, Wo, Wo, Wo, Wo, Wo, Wo, Wo, Wo, Wo, Wo, Wo
