Wog, Wog, Wog, Wwg, Wwg, Wo, Ds, Wo, Gs^Fms, Gs^Fms, Gs^Fp, Gs^Fp, Ss, Gs^Fp, Gs^Fms, Gs^Fms, Gs, Hh, Hh, Mm, Mm, Xu, Xu, Xu, Xu, Xu, Xu, Xu, Xu, Xu, Xu, Xu, Xu, Xu, Xu, Xu, Xu, Xu, Xu, Xu, Xu, Xu, Xu, Xu, Xu, Xu, Xu, Xu, Xu, Xu, Xu, Xu
Wog, Wog, Wog^Edt, Wwg, Wwrg, Wwg, Wwg, Ds, Gs^Fms, Gs^Fms, Gs^Fmw, Gs^Fp, Ss, Gs^Fp, Gs^Fdw, Gs^Fms, Gs, Hh, Hh, Mm, Mm, Xu, Xu, Xu, Xuc, Xu, Xu, Xu, Xu, Xu, Xu, Xuc, Xuc, Xu, Xu, Xu, Xu, Xu, Xu, Xu, Xu, Xu, Xu, Xu, Xu, Xu, Xu, Xu, Xu, Xu, Xu, Xu
Wog, Wog, Wog^Edt, Wwg^Edt, Wwg, Wwg, Wwg, Gs^Fmw, Gs^Fetd, Gs^Fms, Gs^Fms, Gs^Fp, Ss, Ss, Gs^Fmw, Gs^Fdw, Gs, Gs, Gd, Hh, Gd, Mm, Xuc, Uu, Uu^Vu, Cer, Cer, Cer, Cer, Cer, Uu, Uu, Uu, Xu, Mm, Xu, Xu, Xu, Xu, Xu, Xu, Xu, Xu, Xu, Xu, Xu, Xu, Xu, Xu, Xu, Xu, Xu
Wog, Wog, Wog, Wog, Wog, Wwg^Vm, Wwg, Ds^Edb, Gs^Fmw, Gs^Fms, Gs^Fmw, Gd^Fmw, Gs^Fmw, Gs^Fmw, Gs, Gs^Fmw, Gs, Gs^Fms, Gs^Vhr, Gd, Hh, Rb, Rb, Uu, Uu, Uu, Uu, Cer, Uu, Uu, Uu, Uu, Xu, Xu, Mm, Mm, Mm, Mm, Mm, Mm, Mm, Mm, Mm, Mm, Mm, Mm, Mm, Mm, Mm, Mm, Mm, Mm
Wog, Wog, Wog, Wog, Wog, Wwg, Wwg, Ds^Edb, Gs^Fms, Gs^Fmw, Gll^Fms, Gs^Fms, Gs^Fms, Gs, Gs^Fms, Gs, Gs^Fms, Gs^Fdw, Hh^Fp, Hh, Mm, Hh, Hh, Uu, Xu, Uu, Uu, Uu, Uu, Uu, Uu^Vud, Uu, Xu, Mm, Mm, Mm, Mm, Mm, Mm, Mm, Mm, Mm, Mm, Mm, Mm, Mm, Mm, Mm, Mm, Mm, Mm, Mm
Wog, Wog, Wog, Wog, Wog, Wwrg, Wwg, Gll^Fms, Gd^Fmw, Gs^Fmw, Gs, Gs, Gs, Gs, Gd^Fmw, Gs^Fms, Gd^Fmw, Hh^Fms, Gs^Fms, Hh^Fms, Hh, Mm, Mm, Xu, Xu, Xu, Uu, Uu, Xu, Xu, Xu, Xu, Xu, Mm, Hh^Vhhr, Hh, Hh, Hh, Hh, Hh, Hh, Hh, Hh, Hh, Hh, Hh, Hh, Hh, Hh, Hh, Hh, Hh
Wog, Wog, Wog, Wog, Wog, Wwg, Wwg, Wwg, Gll^Fms, Gs^Fms, Gll, Gs, Gg, Gg, Gd^Fmw, Gs^Fms, Gd^Fmw, Gs^Fms, Gs, Gs, Hh, Mm, Mm, Xu, Mm, Xu, Hh, Rb, Rb, Hh, Hh, Mm, Mm, Mm, Hh, Gs, Gs, Gs, Gll, Gs, Gs, Gs, Gs, Gs, Gs, Gll, Gs, Gs, Gs, Gs, Gll, Gs
Wog, Wog^Edt, Wog^Edt, Wog^Edt, Wog^Edt, Wwg, Wwg, Wwg, Ds, Gs^Fmw, Gs, Gs, Gs, Gg, Gg, Gs^Fms, Gg, Gs^Fms, Gs, Hh, Hh, Mm, Hh, Mm, Hh, Mm, Hh, Rb, Rb, Gd, Gd, Hh, Hh, Hh, Hh, Gs, Gs, Gll, Gll, Gll, Gs, Gs, Gll, Gs, Gs, Gs, Rd^Gvs, Rb^Gvs, Rd^Gvs, Gll, Gll, Gll
Wog, Wog^Edt, Wog^Edt, Wog^Edt, Wog^Edt, Wog, Wwg, Wwg, Wwg, Ds, Ss^Edb, Ss, Gs, Gg, Rb^Gvs, Gg, Gg, Gg, Gg, Gg, Hh, Hh, Hh, Hh, Gs, Hh, Gd, Gd, Gd, Rb, Gd, Gd, Gd, Gs, Rb, Rb, Rb, Rb, Rb, Gs, Rd^Gvs, Rd^Gvs, Re^Gvs, Gs, Rb^Gvs, Rd^Gvs, Rb^Gvs, Rd^Gvs, Re^Gvs, Rb^Gvs, Rd^Gvs, Gll
Wog, Wog, Wog, Wog, Wog, Wog, Wog, Wwg, Ds, Ds^Edb, Gs^Edb, Gs, Gd^Fmw, Gg, Rd^Gvs, Re^Gvs, Rd^Gvs, Gg, Gg, Gs, Gs, Gs, Gs, Gs, Gs, Gd, Gs, Gs, Gd, Gs, Rb, Gs, Rb, Rb, Gs^Fmw, Gs^Fmw, Gs^Fmw, Gs^Fmw, Gs^Fmw, Rd^Gvs, Rd^Gvs, Rb^Gvs, Rd^Gvs, Rd^Gvs, Re^Gvs, Rb^Gvs, Cte, Wwf, Wwf, Rb^Gvs, Rb^Gvs, Rd^Gvs
Wog, Wog, Wog, Wog, Wog, Wog, Wog, Wwg, Wwg, Ds^Edb, Gll, Gll, Gll^Edb, Gg, Gs^Vl, Rb^Gvs, Gg, Gg, Gs^Fmw, Gs^Fmw, Gs^Fdw, Gg, Gll, Gg, Gs, Gs, Gs^Fms, Gs^Vht, Gs^Fms, Gs, Gs, Gs, Rb, Gs, Gs^Fmw, Gs^Fmw, Gs^Fmw, Gs^Fdw, Gs^Fmw, Gs^Fmw, Gs^Fmw, Rb^Gvs, Re^Gvs, Rb^Gvs, Rd^Gvs, Wwf, Cte, 4 Kte, Wwf, Re^Gvs, Rb^Gvs, Re^Gvs
Wog, Wog, Wog, Wog, Wog, Wog, Wog, Wog, Wog, Wwg, Wwg, Wwg, Ds, Gg, Gg, Gg, Gg, Gs^Fms, Gs^Fmw, Ss, Gs^Fms, Gll, Gll, Gs, Gll, Gs, Gs^Fmw, Gs^Fmw, Gs^Fmw, Gs, Rb, Gs, Gg, Gg, Gg, Gs^Fms, Gs^Fdw, Gs^Fms, Gs^Fms, Gs^Fms, Gs^Fmw, Gs^Fms, Re^Gvs, Rb^Gvs, Rb^Gvs, Wwf, Ss, Cte, Wwf, Re^Gvs, Rb^Gvs, Re^Gvs
Wog, Wog, Wog, Wog, Wog^Edt, Wog, Wog^Edt, Wog, Wog, Wog, Wwg, Wwg, Wwg, Ds, Co, 3 Ko, Gs, Gd^Fmw, Gs^Fp, Gs^Fmw, Gs^Fms, Gg, Ss, Gll, Gll, Gs, Gll, Gs^Fms, Re, Gs, Gg, Gs, Gll, Gs, Gll, Gll, Ss, Gs, Gs, Gs, Gs, Gs, Ss, Rd^Gvs, Gs, Ss, Gll, Ss, Gs, Gs, Gs, Gs
Wog, Wog, Wog, Wog, Wog, Wog^Edt, Wog, Wog, Wog, Wog, Wwg, Wwg, Wwg, Wwg, Wwg, Co, Gs, Gs^Fms, Gs^Fmw, Gs^Fms, Gs^Fmw, Ss, Ss, Gs^Fmw, Gg, Gg, Gs^Edb, Gg^Edb, Re, Gll, Gll, Ss, Gll, Re, Gll, Gll, Ss, Ss, Ss, Ss, Gs, Ss, Gs, Gll, Ss, Gs, Ss, Gs, Gs, Ss, Ss, Ss
Wog, Wog, Wog, Wog, Wog, Wog, Wog, Wog, Wog, Wog, Wwg, Wwg, Wwg^Edt, Wwg, Wwg, Wwg, Ds, Gs^Fmw, Gs^Fmw, Gs^Fms, Ss, Ss, Gs^Fmw, Gs^Fms, Gg, Gll, Gg, Gs^Edb, Re, Gll, Ss, Ss, Gg, Re, Gs, Gs^Vhr, Ss, Ss, Ss, Gs, Ss, Gs, Ss, Gs, Gs, Ss, Gll, Ss, Gs, Gll, Gs, Ss
Wog, Wog, Wog, Wog, Wog, Wog, Wog, Wog, Wog, Wog, Wwg, Wwg^Edt, Wog^Edt, Wwg^Edt, Wwg, Ds, Ds, Gs, Gs^Edb, Gs^Fms, Gg, Ss, Gs, Gs^Fmw, Gs, Gll, Re, Re, Sm, Gs^Vhr, Ss, Ss, Ss, Gs, Re, Ss, Ss, Ss, Gs, Gs, Gll, Gs, Ss, Ss, Gll, Gs, Gs, Gll, Ss, Gs, Ss, Ss
Wog, Wog, Wog, Wog, Wog, Wog, Wog, Wog, Wog, Wog, Wog, Wog, Wog^Edt, Wwg^Edt, Wwg, Ds, Ds, Gs, Gs, Gg, Ss^Edb, Ss^Edb, Ss^Edb, Gg, Gll, Sm, Re, Gs, Wwg, Sm, Ss, Ss, Gg^Edb, Gg, Gs, Re, Gg, Gg, Gs, Ss, Gll, Gs, Gll, Gs, Gll, Ss, Gs, Gs, Ss, Gs, Gs, Gs
Wog, Wog, Wog, Wog, Wog, Wog, Wog, Wog, Wog, Wog, Wog, Wog, Wog, Wwg, Wwg, Wwg, Gs, Gs, Gll, Ss^Edb, Ss^Edb, Gll^Vhr, Gll^Edb, Ss^Edb, Wwg^Edb, Wwg, Wwg^Bsb|, Wwg^Edb, Wog^Edb, Wwg^Edb, Wwg^Edb, Gll, Gll, Gll, Re, Gs, Gg, Ss, Gll, Gs, Gs, Gll, Gs, Gll, Gs, Gs, Gll, Ss, Ss, Gll, Gll, Gs
Wog, Wog, Wog, Wog, Wog^Edt, Wog, Wog, Wog, Wog, Wog, Wog, Wog, Wog, Wog, Wwg, Wwg, Gs, Gs, Gll, Ss^Edb, Ss^Edb, Gg, Wwg^Edb, Wwg^Edb, Wog^Edb, Wwg, Wwg^Bsb|, Wwg^Edb, Wwg^Edb, Wog^Edb, Wwg, Gg, Re, Re, Ss, Ss, Gs^Fms, Gll, Gs^Fms, Gll^Fms, Gll^Fms, Gs^Fms, Gs^Fms, Gs^Fms, Gs^Fms, Ss, Ss, Ss, Gs, Gs, Gs, Gs^Fms
Wog, Wog, Wog, Wog^Edt, Wog^Edt, Wog^Edt, Wog^Edt, Wog, Wog, Wog, Wog, Wog, Wog, Wog, Wwg, Wwg, Wwg, Gs, Gll, Gll, Wwg^Edb, Wwg^Edb, Wog^Edb, Wog^Edb, Sm, Wwg, Rp, Gll, Wwg^Edb, Wwg^Edb, Wwg^Bsb/, Sm^Bsb/, Ss, Gg, Ss, Gll, Gll^Fmw, Gll^Fms, Gll^Fms, Gs^Fdw, Gll^Fms, Gll^Fdw, Gll^Fms, Gs^Fdw, Gs^Fms, Gs^Fms, Ss, Gll^Fms, Gs^Fdw, Gll^Fms, Ss, Gll^Fms
Wog, Wog, Wog, Wog^Edt, Wog^Edt, Wog^Edt, Wog, Wog, Wog, Wog, Wog, Wog, Wog, Wog, Wwg, Wwg, Wwg, Sm, Gs^Vhr, Sm, Wwg^Edb, Wog^Edb, Wwg^Edb, Wwg, Gll, Chr, Rp, Chr^Dr, Rp, Wwg^Bsb/, Wwg^Edb, Wwg, Wog, Wwg, Wwg, Sm, Wwg, Gs^Fmw, Gs^Fmw, Gs^Fp, Gs, Gs, Gll^Fmw, Ss, Gs^Fp, Gs, Gs^Fp, Gs^Fp, Gs^Fp, Gll^Fp, Ss, Gs^Fp
Wog, Wog, Wog, Wog, Wog, Wog, Wog, Wog, Wog, Wog, Wog, Wog, Wog, Wog, Wwg, Wwg, Wwg, Sm, Wwg, Wwg, Wog, Wwg^Edb, Wwg^Bw\r, Ds, Gll, Gs, Rp, Rrc, Gs, Ch, Gg^Edb, Wwg, Wwg, Wog, Wog^Edb, Wwg^Edb, Wwg^Edb, Ss, Wwg, Gll^Fp, Gll^Fmw, Gs^Edb, Gll^Fp, Gll^Fmw, Gs^Fp, Gs^Edt, Gs^Fmw, Ss, Ss, Ss^Fp, Gll^Fp, Gs^Fp
Wog, Wog, Wog, Wog, Wog, Wog, Wog, Wog, Wog, Wog, Wog, Wog, Wog, Wog^Edb, Wog^Edb, Wwg, Wwg, Wwg, Ss, Wog, Wwg, Wwg, Ds, Ds, Rp, Rrc^Vh, Rp, Gll^Fdw, Gll^Fdw, Gll, Gll, Sm^Edb, Gll^Fdw, Wwg, Wwg^Edb, Wog^Edb, Wog^Edb, Wwg, Wwg, Wwg^Edb, Wwg^Edb, Wwg^Edb, Wwg, Wwg, Wwg^Edt, Wwg^Edt, Wwg^Edt, Ss, Gll^Fp, Gs^Fmw, Gs^Fp, Gs^Fp
Wog, Wog, Wog, Wog, Wog, Wog, Wog, Wog, Wog, Wog, Wog, Wog, Wog, Wog^Edb, Wog, Wog^Edb, Wwg, Wwg, Wwg, Wwg, Wwg, Wwg^Bw\r, Ds, Rr, Rp^Vhc, Rr, Rrc, Gs, Gg, Rrc^Vhc, Gs, Gs, Gll, Gll^Fdw, Sm, Wwg^Edb, Wog, Wog, Ss, Wog, Wog, Wog, Wog, Wog, Wog, Wog^Edt, Ss, Wwg, Wwg, Wwg, Wwg^Edb, Wwg
Wog, Wog, Wog, Wog, Wog, Wog, Wog, Wog, Wog, Wog, Wog, Wog, Wog, Wog, Wog, Wwg, Wwg, Wwg^Bw\r, Ds, Sm, Gll, Wwg, Wwg^Edb, Gg, Gg, Gs, Rrc, Rp, Rp, Gs, Gs, Gg, Gg^Edb, Ds^Edb, Wwg, Wwg, Wog, Wog, Wog, Ss, Wog, Wog, Wog, Wog, Wog, Wog, Wog, Wog^Edb, Wog^Edb, Wog^Edb, Wog^Edb, Wog
Wog, Wog, Wog, Wog, Wog, Wog, Wog, Wog, Wog, Wog, Wog, Wog, Wog, Wog, Wwg, Wwg, Wwg, Ds, Rr, Gs, Re^Vhr, Wwg^Edb, Wwg^Edb, Chr, Rp, Rp, Chr, Ch, Ch, Rrc, Gs, Gg, Ds^Esd, Ds^Edb, Wwg, Wog, Wwg, Wog, Wog, Wog, Wog^Edb, Wog^Edb, Wog^Edb, Wog^Edb, Wog^Edb, Ss, Wog, Wog^Edb, Wog, Wog^Edb, Wog, Wog
Wog, Wog, Wog, Wog, Wog, Wog, Wog, Wog, Wog, Wog, Wog, Wog, Wog, Wog, Wwg, Wwg, Wwg^Bw\, Ds, Gs, Rp, Rp, Gll, Wwg^Bw/, Rp, Gs, Rp, Ch, 2 Kh, Chr, Rr, Rr^Vhcr, Gll, Ds^Edb, Wwg, Wog, Wwg, Ss, Wwg, Wwg, Wwg, Wwg, Wwg, Wwg, Wwg, Wwg, Wog, Wog, Wog, Wog, Wog^Edb, Wog, Wog
Wog, Wog, Wog, Wog, Wog, Wog, Wog, Wog, Wog, Wog, Wog, Wog, Wog, Wog, Wwg, Wwg, Wwg, Ds, Rp, Rr, Re^Vhr, Rr, Wwg^Edb, Ch, Gll, Rrc, Rrc, Chr, Rp, Rrc, Gll, Gll^Edb, Wwg, Wwg, Wwg^Edb, Wwg^Edb, Gll^Edb, Wwg, Gs, Gll, Gd, Sm, Sm, Ss, Wwg, Wwg, Wwg^Edb, Wog, Wog, Ss, Wog, Wog^Edb
Wog, Wog, Wog, Wog, Wog, Wog, Wog, Wog, Wog, Wog, Wog, Wog, Wog, Wog, Wwg, Wwg, Wwg^Bw/r, Ds, Ds, Gs, Gll, Gg, Wwg^Edb, Gs, Gll^Fdw, Rrc^Vhc, Gs, Rp, Rp, Gll^Fdw, Gs, Chr, Wwg, Wog^Edb, Wwg^Edb, Gs^Edb, Gg, Gs, Gll^Fdw, Gll^Fmw, Gll^Fmw, Sm, Gll, Gs, Gll, Wwg, Wwg^Edb, Wwg^Edb, Wwg, Wog, Wwg^Edb, Wog
Wog, Wog, Wog, Wog^Edb, Wog^Edb, Wog^Edb, Wog, Wog, Wog, Wog, Wog, Wog, Wog, Wog, Wog, Wwg, Wwg, Wwg, Wwg^Bw/, Ds, Gs, Wwg^Edb, Wwg, Gll^Fdw, Gll^Fdw, Gll^Fdw, Rr^Vh, Gs, Rr, Rrc, Rp, Rp, Wwg^Dr, Wwg^Edb, Gg^Edb, Gd^Edb, Gg^Vh, Gg, Gll^Fmw, Gll^Fmw, Gg, Gd, Rb^Gvs, Gd, Gs, Wwg, Wwg^Edb, Wwg^Edb, Wwg^Edb, Wwg, Wwg, Wwg^Edb
Wog, Wog, Wog, Wog^Edb, Wog^Edb, Wog, Wog, Wog, Wog, Wog, Wog, Wog, Wog, Wog, Wog, Wwg^Edb, Wwg, Wwg, Wwf, Wwf, Wwg, Wwg, Wog, Wwg, Ds, Gg, Rp, Rrc, Rp, Rrc^Vhr, Gll, Chr, Wwg, Wwg^Bsb\, Re, Gg, Gg, Gg, Gg, Gll^Fmw, Gg, Rd^Gvs, Re^Gvs, Rd^Gvs, Rb^Gvs, Gs, Wwg^Edb, Wwg^Edb, Gd, Gll, Gs, Wwg
Wog, Wog, Wog, Wog, Wog, Wog, Wog, Wog, Wog, Wog, Wog, Wog, Wog^Edb, Wog^Edb, Wog, Wog, Wwg^Edb, Wwg, Wwf, Wwf^Edb, Wwg, Ss, Wwg, Wwg^Bw/r, Ds, Rp, Gll, Gs, Rr, Gll, Ds, Ds, Wwg, Wwg, Sm, Re, Gg, Gg, Gg, Gg, Gg, Rb^Gvs, Rb^Gvs, Rb^Gvs, Rd^Gvs, Gs, Wwg, Wwg^Edb, Wwg, Gll, Gll, Gll
Wog, Wog, Wog, Wog, Wog, Wog, Wog, Wog, Wog, Wog, Wog, Wog^Edb, Wog^Edb, Wog^Edb, Wwg, Wwg, Wwg, Sm, Gs, Wwf, Wwg, Wog, Wwg^Edb, Wwg, Ww^Bw/r, Ds, Gs, Chr, Wwg^Bsb|, Ch, Wwg^Edt, Wwg, Wwg^Edt, Wwg, Ss, Re, Gd, Gg, Gs^Fms, Gg, Gg, Rd^Gvs, Re^Gvs, Re^Gvs, Rb^Gvs, Gs, Ss^Edb, Wwg, Wwg, Wwg, Gll, Gg
Wog, Wog, Wog, Wog, Wog, Wog, Cme, Cme, Cme, Wog, Wog, Wog, Wog, Wog, Wwg, Wwg, Sm, Gs, Gg, Sm, Wwg, Wog, Wwg, Wwg, Wwg^Edb, Wwg, Ss, Wwg, Wwg^Dr, Wwg^Edt, Wwg^Edt, Wwg^Edt, Gg^Edt, Sm, Sm, Re, Gg, Ss, Gs^Fms, Gs, Gs, Rd^Gvs, Rb^Gvs, Rb^Gvs, Re^Gvs, Rb^Gvs, Wwg, Gll^Edb, Wwg^Edb, Wwg^Edb, Gll, Gll
Wog, Wog, Wog, Wog, Wog, Wog, Cme, 1 Kme, Cme, Wog, Wog, Wog, Wog, Wwg, Wwg, Gs, Gd^Fmw, Gs^Fds, Gg, Gll, Gg, Wwg, Sm, Wwg^Edb, Wwg, Wwg, Wwg, Wwg, Re, Wwg^Edt, Gg, Gs^Edt, Gg, Gd, Gg, Re, Sm, Ss, Gg, Gg, Gg, Gg, Gs^Vl, Rd^Gvs, Gg, Gs, Wwg, Ss^Edb, Wwg^Edb, Wwg^Edb, Wwg, Gll
Wog, Wog, Wog, Wog, Wog, Wog, Wog, Cme, Wog, Wog, Wog, Wog, Wog, Wwg, Wwg, Gll, Gs^Fds, Gs^Fmw, Gg^Vhr, Gll, Gll, Sm, Ss, Sm, Gs, Gll, Sm, Sm, Re, Gs, Gs, Gll, Gg, Gg, Re, Re, Sm, Sm, Gll^Fmw, Gs, Gs, Gs, Gs, Gs, Ss, Ss, Sm^Fmw, Gll^Fmw, Hh, Wwg^Edb, Wwg, Hh
Wog, Wog, Wog, Wog, Wog, Wog, Wog^Edb, Wog, Wog, Wog, Wog, Wog, Wog, Wwg, Wwg, Gs, Gs, Gs^Fds, Gll, Gg, Gll, Gll, Gs, Gg, Gll, Gg, Gs, Gs, Re, Gs, Gg, Gs, Gs, Gll, Re, Gg, Gs^Fms, Ss, Gs^Fms, Gs^Fms, Gll^Fmw, Gg, Gg, Gs, Wwg, Wwg, Sm^Fmw, Sm^Fms, Hh, Hh, Wwg, Wwg
Wog, Wog, Wog, Wog, Wog, Wog, Wog^Edt, Wog, Wog, Wog, Wog, Wog, Wog, Wog, Wwg, Gll^Edb, Gs^Edb, Gs, Gs, Gg, Gs^Fds, Gg, Gg, Gll, Gg, Gll, Gg, Gg, Gs^Fds, Re, Gll, Gll, Gs, Gg, Re, Gd^Vhr, Gs^Fds, Gll^Fmw, Ss^Fms, Ss^Fmw, Ss^Fms, Gll^Fmw, Ss^Fms, Gll^Fmw, Ss, Gs^Fms, Gll^Fdw, Gll^Fmw, Gll^Fmw, Hh, Wwg, Wwg
Wog, Wog, Wog, Wog, Wog^Edt, Wog^Edt, Wog^Edt, Wog^Edb, Wog, Wog, Wog, Wog, Wog, Wog, Wwg, Wwg^Edb, Ds^Edb, Gs, Gs^Fds, Gs^Fds, Gs^Fds, Gs^Fmw, Gg, Gg, Gg, Gd^Vhr, Gg, Gs^Fds, Gs^Fds, Re, Gs^Fds, Gd, Gg^Vhr, Gll, Re, Gs^Fds, Gll^Fds, Ss, Gs^Fds, Gs^Fds, Gs^Fds, Gs^Fds, Gll^Fdw, Gs^Fds, Ss, Gll^Fdw, Gs^Fds, Sm^Fds, Gs^Fds, Hh, Wwg, Wwg
Wog, Wog, Wog, Wog, Wog, Wog^Edt, Wog, Wog, Wog, Wog, Wog, Wog, Wog, Wwg, Wwg^Edb, Wwg^Bw\r, Ds, Gs, Gll^Dr, Gs^Fds, Gs^Fms, Gll^Fmw, Gs^Fms, Gs^Fds, Gg, Gg, Gg, Gg, Gg, Re, Gs^Fds, Gs^Fds, Gll^Fds, Gg, Re, Gg, Gg, Gs^Fms, Gg, Ss, Gs^Fds, Gg, Ss, Wwg^Edb, Wwg^Edb, Gg, Ss^Feth, Sm, Ss, Ss, Gg, Wwg
Wog, Wog, Wog, Wog, Wog, Wog, Wog, Wog, Wog, Wog, Wog, Wog, Wog, Wwg, Wwg^Bw\, Ds, Re, Gs, Gs^Fds, Gll^Fmw, Gll^Fmw, Gs^Fds, Gg, Gll^Fmw, Re, Gll, Re, Gg, Re, Re, Re, Gs^Fds, Re, Gs, Re, Gs, Re^Gvs, Re^Gvs, Gg, Gll^Fdw, Gg, Ss, Gs, Wwg^Edb, Ss, Gll^Fdw, Gs^Fds, Gg, Wwg, Wwg, Gg, Wwg
Wog, Wog, Wog, Wog, Wog, Wog, Wog, Wog, Wog, Wog, Wog, Wog, Wog, Wwg, Wwg, Ds, Gs, Re, Gs^Fds, Gs, Gs^Fmw, Gg, Gs^Fds, Re, Gs^Fds, Re, Gg, Re, Gs, Gs, Gg, Re, Gll^Fms, Re, Gs^Fds, Gll, Gll, Re^Gvs, Gs, Gs^Fds, Gs^Edb, Ss, Chs, Chs, Gg, Gs^Fds, Gll^Fdw, Gg, Wwg, Gg, Gg, Wwg
Wog, Wog, Wog, Wog, Wog, Wog, Wog, Wog, Wog, Wog, Wog, Wog, Wog, Wwg, Ds, Gs, Gs, Gs, Gs, Gs^Fds, Gg, Gs^Fds, Gg, Gs^Fds, Gg, Gg, Gg, Gg, Re^Gvs, Re^Gvs, Gs, Re, Gg, Gs^Fmw, Gg, Gll^Fms, Gll^Fds, Gs, Gll, Gg, Gg, Chs, 5 Ket, Chs^Dr, Chs, Gg, Ss, Wwg^Edb, Gg^Edb, Gs, Gg, Gg
Wog, Wog, Wog, Wog, Wog, Wog, Wog, Wog, Wog, Wog, Wog, Wog, Wog, Wwg, Wwg, Ds, Gs, Gs^Dr, Re^Gvs, Re^Gvs, Gll, Gs, Gll, Gll, Hh, Gg, Mm, Re^Gvs, Re^Gvs, Re^Gvs, Gs, Re, Gg, Gs, Gs, Gll^Fmw, Gll^Fmw, Gs^Fmw, Gg, Gll, Gg, Gg^Dr, Chs, Chs, Gs^Fds, Wwg^Edb, Gll, Wwg^Edb, Gll, Gs, Gg, Gg
Wog, Wog, Wog, Wog, Wog, Wog, Wog, Wog, Wog, Wog, Wog, Wog, Wog, Wwg, Wwg, Ds, Gs, Re^Gvs, Re^Gvs, Re^Gvs, Mm, Gg, Gg, Gg, Hh, Mm, Mm, Mm, Mm, Gs, Gg, Re, Gg, Gg, Gg, Gs^Fds, Gs^Fds, Gs^Fms, Gg, Gs^Fds, Gs^Fds, Gg, Ss, Gs^Fds, Ss, Wwg, Gg, Gs, Gg, Gs, Gg, Gg
Wog, Wog, Wog, Wog, Wog, Wog, Wog, Wog, Wog, Wog, Wog, Wog, Wog, Wog, Wwg, Ds, Gs, Re^Gvs, Gs, Gs, Mm, Hh, Gs, Gg, Gs, Hh, Hh, Hh, Mm, Gs^Vh, Gg, Re, Re, Gg, Gs, Gs^Fds, Gs^Fmw, Gs^Fds, Gs, Gs^Fds, Gll, Gs, Gg^Edb, Wwg, Wwg, Ss, Gg, Gll, Gg, Gs, Gg, Gg
Wog, Wog, Wog, Wog, Wog, Wog, Wog, Wog^Edb, Wog^Edb, Wog, Wog, Wog, Wog, Wog, Wog, Wwg, Gll, Gs, Gll, Mm, Mm, Hh, Hh, Hh, Hh, Hh, Mm, Mm, Mm, Mm, Gg, Gg, Re, Gs, Gg, Gs^Fdw, Gs^Fds, Gs^Fds, Gll, Gs, Gs, Gll, Gg, Gll, Gg, Gll, Gll, Gll, Gg, Gg, Gg, Gg
Wog, Wog, Wog, Wog, Wog, Wog, Wog, Wog^Edb, Wog^Edb, Wog^Edb, Wog, Wog, Wog, Wog, Wwg, Wwg, Gll, Gs, Gll, Mm, Gs^Vh, Mm, Gs, Mm, Mm, Mm, Mm, Gs, Gg, Gg, Gg, Gs, Gg, Re, Gg, Gs^Fds, Gs^Fmw, Gs^Fds, Gs, Gs, Gll, Gg, Gll, Gll, Gll, Gll, Gll, Gll, Gg, Gg, Gg, Gg
Wog, Wog, Wog, Wog, Wog, Wog, Wog^Edb, Wog^Edb, Wog^Edb, Wog, Wog, Wog, Wog, Ww^Vm, Wwg, Ds, Gs, Gs, Gg, Mm, Mm, Gs, Mm, Mm, Mm, Gs, Gg, Mm, Re^Gvs, Rb^Gvs, Rd^Gvs, Gg, Gs, Re, Gll, Gg, Gg, Gs^Fds, Gs, Gg, Gg, Gg, Gg, Gg, Gg, Gll, Gg, Gg, Gg, Gg, Gg, Gg
Wog, Wog, Wog, Wog, Wog, Wog^Edb, Wog^Edb, Wog^Edb, Wog, Wog, Wog, Wog, Wog, Wog, Wwg, Ds, Ds, Gs, Gs, Gg, Mm, Mm, Mm, Gs, Gll, Gs, Gg, Rb^Gvs, Rd^Gvs, Rb^Gvs, Rb^Gvs, Re^Gvs, Gg, Re, Gg, Gg, Gg, Gg, Gs, Gg, Gg, Gs, Hh, Hh, Hh, Gg, Hh, Gg, Gg, Gg, Gg, Gg
Wog, Wog, Wog, Wog, Wog, Wog, Wog, Wog, Wog, Wog, Wog, Wog, Wog, Wog, Wog, Wwg, Ds, Gs, Gll, Gll, Gll, Gg, Gg, Gg, Gg, Gg, Gg, Gll, Gg, Re^Gvs, Gg, Gs, Re, Re, Gs^Vh, Hh, Hh, Gg, Gg, Gs, Gg, Gg, Hh, Hh, Hh, Hh, Hh, Hh, Hh, Gs, Hh, Gg
Wog, Wog, Wog, Wog, Wog, Wog, Wog, Wog, Wog, Wog, Wog, Wog, Wog, Wog, Wog, Wwg, Ds, Gs, Gll, Gll, Gs^Fdw, Gg, Gg, Gs^Fmw, Gg, Gg, Gg, Gs, Gs, Re, Re, Gs, Re, Gs, Gs^Fds, Hh, Hh, Hh, Gg, Gg, Hh, Gg, Hh, Hh, Hh, Hh, Hh^Fdw, Hh^Fmw, Hh, Hh, Hh, Hh
Wog, Wog, Wog, Wog, Wog, Wog, Wog, Wog, Wog, Wog, Wog, Wog, Ww^Vm, Wog, Wwg, Wwg, Ds, Gs, Gs, Gll^Fds, Gs^Fds, Gs^Fds, Gs^Fmw, Gg, Gll, Gg, Gg, Gs, Re, Re, Gs, Re, Gs, Re, Re, Gs, Gs, Hh, Hh, Hh, Hh, Hh, Hh, Hh, Hh, Hh, Hh, Hh, Hh, Hh, Hh, Hh
Wog^Edb, Wog^Edb, Wog^Edb, Wog, Wog, Wog, Wog, Wog, Wog, Wog, Wog, Wwg, Wwg, Wwg, Ds, Ds, Gs, Gs, Gg, Gg, Gs^Fmw, Gg^Vh, Gs^Fds, Gg, Gll, Gg, Gg, Gs, Re, Gs, Gs, Gs, Hh, Re, Gg, Gs, Hh, Hh, Hh, Hh, Hh, Hh, Hh, Hh^Fds, Hh, Hh, Hh^Vhh, Hh, Hh^Fds, Hh, Hh, Hh
Wog^Edb, Wog^Edb, Wog, Wog, Wog, Wog, Wog, Wog, Wog, Wog^Edt, Wog^Edt, Wwg, Wwg, Wwg, Ds, Gll, Gs, Gs, Gll, Gg, Gs^Fds, Gs^Fds, Gll^Fdw, Gll, Gll, Gg, Gg, Gg, Re, Gs, Gg, Gs, Hh, Re, Gg, Hh, Hh, Hh, Gg, Hh, Hh, Hh, Hh, Hh, Hh, Hh, Hh^Fds, Hh, Hh, Hh, Hh, Hh
Wog, Wog, Wog, Wog, Wog, Wog, Wog, Wog, Wog, Wog^Edt, Wog^Edt, Wwg^Edt, Wwg, Wwg, Gll, Gs, Gg, Gll, Gg, Gg, Gg^Fdw, Gll^Fds, Gll, Gll, Gg, Gg, Gg, Gg, Re, Gg, Gg, Gg, Gg, Re, Gg, Hh, Gg, Hh, Gg, Hh, Hh, Hh^Fds, Hh, Hh, Hh, Hh, Hh, Hh, Hh, Hh^Fds, Hh, Hh
