Gs, Gg, Gs, Gg, Gs, Gs, Gs, Gs, Gs, Gg, Gg, Gg, Gg, Gg, Gg, Gg, Gg, Gg, Re, Gg, Gg, Gg, Gg, Gg, Gs, Gg, Gs, Gs, Gs, Gs, Gs, Gg, Gg, Gg, Gg, Gg, Gs, Gg, Gs, Gg, Gd, Gg, Hhd, Hhd, Hhd, Hhd, Hhd, Hhd, Hhd, Hhd, Hhd, Hhd, Hhd, Hhd, Ds, Gg, Gg, Gg, Gg, Gg, Gg, Gg, Gg, Gg, Gg, Gg, Gg, Gg, Gg, Gg, Gg, Gg, Gg, Gg, Gg, Gg, Gg, Gg, Gg, Gg, Gg, Gg
Gs, Gs, Gs, Gs, Gs, Gs, Gs, Gs, Gd, Gs, Gs, Gg, Gg, Gg, Gg, Gg, Gg, Gg, Rp, Rp, Gg, Gg, Gg, Gg, Gg, Gs, Gs, Gs, Gs, Gs, Gg, Gs, Gs, Gg, Gg, Gs, Gs, Gs, Gs, Gd, Gd, Gd, Hhd, Hhd, Hhd, Hhd, Hhd, Hhd, Hhd, Hhd, Hhd, Hhd, Ds, Ds, Ds, Ds, Ds, Gg, Ds, Gg, Gg, Gg, Gg, Gg, Gg, Gg, Gg, Gg, Gg, Gg, Gg, Gg, Gg, Gg, Gg, Gg, Gg, Gg, Gg, Gg, Gg, Gg
Gg, Gs, Gs, Gs, Gd, Gd, Gd, Gd, Gd, Gd, Gs, Gs, Gs, Gg, Gg, Gg, Gg, Gg, Gg, Rp, Re, Gg, Gg, Gg, Gg^Efm, Gg, Gg, Gg^Edt, Gg, Gg, Gg, Gg, Gg, Gg, Gg, Gs, Gs, Gs, Gs, Gd, Hhd, Hhd, Hhd, Hhd, Hhd, Hhd, Hhd, Hhd, Ds, Hhd, Hhd, Hhd, Ds, Ds, Ss, Ss, Ss, Ss, Ss, Ds, Ss, Ss, Ss, Gg, Gg, Gg^Vh, Gg, Gg, Gg, Gg, Gg, Gg^Efm, Gg^Efm, Gg^Efm, Gg^Efm, Gg, Gg^Es, Gg^Efm, Gg^Efm, Gg, Gg, Gg
Gg, Gs, Gd, Gd, Gd, Gd, Gs, Gd, Gd, Gs, Gs, Gs, Gg, Gg, Gg, Gg, Gg, Gg, Gg, Gg, Gg, Re, Gg, Gg, Gg, Gg, Gg^Efm, Gg, Gg, Gg, Gg, Gg, Gs^Fds, Gs^Fds, Gs^Fds, Gg, Gs, Gs, Gs, Gd, Hhd, Hhd, Hhd, Hhd, Ds, Hhd, Ds, Ds, Hhd, Hhd, Hhd, Hhd, Ds, Ds, Ss, Ss, Ww^Vm, Ss, Ss, Ss, Ss, Ss, Ss, Ss, Ss, Gg, Gg, Gg, Gg, Gg, Gg, Gg, Gg, Gg, Gg^Es, Gg, Gg, Gg, Gg, Gg, Gg, Gg
Gg, Gs, Gs, Gs, Gs, Gs, Gs, Gs, Gs, Gs, Gg, Gs, Gg, Gg, Gg, Gg, Gg, Gg, Gg, Gg, Gg, Re, Gs^Fds, Gs^Fds, Gs^Fds, Gs^Fds, Gs^Fds, Gg^Efm, Gs^Fds, Gs^Fds, Gs^Fds, Gs^Fds, Gs^Fds, Gs^Fds, Gs^Fds, Gg, Gs, Gs, Gs, Gd, Hhd, Hhd, Ds, Ds^Edpp, Ds, Ds, Ds, Ds^Edpp, Hhd, Hhd, Ds, Ds, Ds, Ss, Ss, Ss, Wot, Wot, Ss, Ss, Ss, Ss, Ss, Ss, Gg^Efm, Gg^Efm, Gg, Gg^Es, Gg, Gg, Gd, Gg^Es, Gs, Gg, Gs, Gg, Gg, Gg, Gg, Gg, Gg, Gg
Gg^Es, Gs, Gg, Gg, Gg, Gg, Gg, Gg, Gg^Gvs, Gg^Gvs, Gg^Gvs, Gg^Gvs, Gg, Gg, Gg, Gg^Efm, Gg, Gg, Gg, Gg, Gs^Fds, Gs^Fds, Gs^Fds, Gs^Fds, Gs^Fds, Gs^Fds, Gs^Fds, Gs^Fds, Gs^Fds, Gs^Fds, Gs^Fds, Gs^Fds, Gs^Fds, Gs^Fds, Gg, Gg, Gg, Gs, Gs, Hhd, Ds, Hhd, Ds, Ds, Ds, Ds^Edpp, Ds, Ds, Hhd, Hhd, Ds, Ds, Ds, Ss, Ss, Ss, Wwt, Wot, Wwt, Ss, Ss, Ss, Ss, Gg, Gg, Gg, Gg, Gg, Gg, Gs, Gs, Gs, Gs, Gs, Gg, Gg^Vh, Gg, Gg, Gg, Gg, Gg, Gg
Gg, Gg, Gg, Gg, Gg^Gvs, Gg^Es, Gg^Gvs, Gg^Gvs, Gg^Gvs, Gg^Gvs, Gg^Gvs, Gg^Gvs, Gg, Gg, Gg, Gg^Efm, Gg, Gg^Efm, Gg, Gg, Gs^Fds, Gs^Fds, Gs^Fds, Gg^Fet, Gs^Fds, Gs^Fds, Gs^Fds, Gs^Fds, Gs^Fds, Gs^Fds, Gs^Fds, Gs^Fds, Gs^Fds, Gg, Gg^Efm, Gg, Gg, Gg, Gs, Gd, Gd, Ds, Ds, Gd, Ds, Ds, Ds, Ds, Hhd, Ds, Gd, Gd, Ds, Ds, Ds, Ss, Ss, Wwt, Wwf, Ss, Ss, Ss, Ss, Ss, Ss, Ss, Ss, Gg, Gg, Gs, Gg, Gg, Gg, Gg, Gg, Gg, Gg, Gg, Gg, Gg, Ds, Ds
Gg, Gg, Gg, Gg, Gg^Gvs, Gg^Gvs, Gg^Gvs, Gg^Gvs, Gg^Gvs, Gg^Gvs, Gg^Gvs, Gg^Gvs, Gg, Gg, Gg, Gg, Gg^Efm, Gg^Efm, Gg, Gg, Gs^Fds, Gs^Fds, Gs^Fds, Gs^Fds, Gs^Fds, Gs^Fds, Gs^Fds, Gs^Fds, Gs^Fds, Gs^Fds, Gs^Fds, Gs^Fds, Gs^Fds, Gg, Gg, Gg^Efm, Gs, Gs, Gd, Gd, Ds, Ds, Gd, Gd^Esd, Ds, Ds, Gd, Gd, Gd, Gd, Gd, Gd, Gd, Ds, Gs, Ds, Ss, Ss, Wwf, Wwf, Wwt, Ss, Ss, Ss, Ss, Wwt, Wwt, Ss, Wwt, Gg, Wwt, Gg, Wwt, Gg, Wwt, Gg, Gg, Gg, Gg, Ds, Ds, Wwt
Gg, Gg, Gg, Gg^Gvs, Gg^Gvs, Gg^Gvs, Gg^Gvs, Gg^Gvs, Gg, Gg^Gvs, Gg, Gg, Gg, Gg, Gg, Gg, Gg, Gg, Gg, Gg, Gg, Gs^Fds, Gg, Gs^Fds, Gs^Fds, Gs^Fds, Gs^Fds, Gs^Ve, Gs^Fds, Gs^Fds, Gs^Fds, Gs^Fds, Re, Gg, Rp, Gg, Gg, Gs, Gs^Esd, Gd^Esd, Gd, Ds^Esd, Gd^Esd, Ds^Esd, Gd, Gd, Gd, Gd, Gs, Gd, Gs, Gs, Gs, Gs, Gd, Gg, Ss, Ss, Ss, Wwf, Wwt, Ss, Ss, Ss, Ss, Gg, Gg, Wwt, Gg, Wwt, Gg, Wwt, Gg, Wwt, Gg, Wwt, Gg, Gg, Ds, Ds, Wwrg, Wwt
Gg, Gg, Gg, Gg^Gvs, Gg, Gg, Gg, Gg, Gg, Gg, Gg, Gs, Gg, Gg, Gg, Gg, Gg, Gg, Gg, Gg, Gg, Gg, Gg, Gg, Gg, Gs^Fds, Gs^Fds, Gs^Fds, Gg, Gs^Fds, Gg, Gg, Gg, Re, Gs, Rp, Rp, Gg, Gg, Gs^Esd, Gs, Gs, Gs, Gd, Gs, Gs, Gs, Gs, Gd, Gs, Gd, Gd, Gd, Gd, Rd, Gd, Ss, Ss, Ss, Wwf, Wwt, Ss, Ss, Gg, Gg, Gg, Gs, Gg, Gs, Gg, Gs, Gg, Gg, Gg, Gg, Wwt, Wwt, Gg, Wwt, Wwt, Wwt, Wwt
Gg, Gg, Gg, Gg, Gg, Gg, Gg, Gg, Gg, Gg, Gg, Gg, Gg, Gg, Gg^Es, Gg, Gg, Gg, Gs, Gs, Gs, Gs, Gs, Gg, Gg, Gg, Gg, Gg, Gg, Gg, Gs, Gs, Gs, Gs, Gs, Gs, Gs, Re, Re, Re, Rp, Gg, Re, Gs, Gg, Gg, Gg, Gd, Rd, Gd, Rd, Rd, Rd, Rd, Rd, Rd, Ss, Ss, Ss, Ss, Wwt, Wwf, Gg, Gg, Gg, Gs, Gd, Gs, Gs, Gs, Gg, Gg, Gg, Gg, Ds, Gg, Wwt, Wwt, Wwt, Wwt, Wwt, Wwt
Gg, Gg, Gg, Gg, Gg, Gg, Gs, Gg, Gg, Gg, Gg, Gg, Gg, Gs^Vh, Gg^Es, Gg, Gg, Gg, Gs, Gs, Gs, Gg, Gg, Gg, Gg, Gg, Gs, Gg, Gs, Gg, Gs, Gs, Gs, Gs, Gs, Gs^Vh, Gs, Gs, Gg, Gg, Gg, Re, Gg, Rp, Rp, Gg, Gd, Gd, Rd, Rd, Rd, Rd, Rd, Rd, Rd, Rd, Rd, Ss, Ss, Wwf, Wwt, Gd, Gg, Gg, Gs, Gs, Gs, Gd, Gg, Gg, Gg, Gg, Ds, Gg, Wwt, Wwt, Wwt, Wwt, Wwt, Wwt, Wot, Wot
Gg, Gg, Gg, Gg^Edt, Gs, Gs, Gs, Gs, Gs, Gg, Gg, Gg^Efm, Gg, Gg, Gg, Gg, Gg, Gg, Gg, Gg, Gs, Gs, Gd, Gg, Gd, Gs, Gd^Esd, Gs, Gd^Esd, Gs, Gd^Esd, Gs^Esd, Gs, Gg^Esd, Gs^Esd, Gs, Gs^Esd, Gs, Gg, Gg, Gg, Gg, Gg, Gg, Gd, Re, Re, Rd, Rd, Rd, Re, Rd, Cvr, Rd, Rd, Rd, Rd, Wwf, Wwf, Wwt, Wwf, Gd, Gg, Gg, Gg, Gs, Gg, Gs, Gg, Gg, Ds, Ds, Wwt, Wwt, Wwt, Wwt, Wwt, Wwt, Wot, Wot, Wot, Wot
Gg, Gg, Gg, Gs, Gs, Gs, Gg, Gs, Gg, Gg, Gg, Gg, Gg, Gg, Gg, Gg, Gs, Gs, Gs, Gs, Gg, Gd, Ds, Gd, Ds, Ds^Esd, Ds, Gd^Esd, Ds, Ds^Esd, Ds, Ds, Gd^Esd, Gs^Esd, Gs^Esd, Gs^Esd, Gs, Gs, Gg, Gg, Gg, Gg, Gg, Gd, Rd, Rd, Rd, Re, Re, Re, Rd, Cvr, Kvr, Sm, Sm^Ecf, Rd, Wwf, Wwf, Wwt, Wwt, Wwf, Gd, Gg, Gg^Efm, Gg^Efm, Gg^Es, Gg, Gg, Gg, Gg, Ds, Wwf, Wwf, Wwt, Wwt, Wwt, Wot, Wot, Wot, Wot, Wot, Wot
Gg, Gg, Gg, Gg, Gg, Gg, Gg, Gg, Gg, Gg, Gg, Gg, Gg, Gs, Gg, Gg, Ds, Gg, Ds, Ds, Ds, Ds, Ds, Ds^Esd, Ds, Ds, Ds, Ds, Ds^Esd, Ds, Ds^Esd, Ds, Ds, Gd^Esd, Gd, Gs^Esd, Gs, Gg, Gg, Gg, Gg, Gg, Gg, Gd, Rd, Rd, Rd, Rd, Rd, Rd, Rd, Cvr, Cvr, Cv^Fet, Cvr, Re, Wwf, Wwf^Bw\r, Wwt, Wwt, Gd, Gg, Gg, Gg, Gg, Gg^Efm, Gg, Gg, Ds, Ds, Ds, Wwf, Wwf, Wwt, Wwt, Wwt, Wot, Wot, Wot, Wot, Wot, Wot
Gg, Gg, Gg, Gg, Gg, Gg, Gg, Gg, Gg, Gg, Gg, Gg, Ds, Gg, Ds, Ds, Ds, Ds, Ds, Ds, Ds, Ds, Ds, Ds, Wwf, Ds, Ds, Ds, Ds, Ds, Ds, Ds, Ds, Ds, Ds, Gd, Gs, Gs, Gs, Gg, Gg, Gg, Gg, Gd, Gd, Rd, Rd, Rd, Rd, Rd, Rd, Rd, Wwf, Cvr, Wwf, Cvr, Wwf, Wwf, Wwt, Gd, Gd, Gg, Gg, Gg, Gg, Gg, Gg, Gg, Ds, Ds, Wwf, Wwf, Wwf, Wwt, Wwf, Wwt, Wwt, Wot, Wot, Wot, Wot, Wot
Wwf, Gg, Wwf, Gg, Wwf, Gg, Ds, Ds, Ds, Ds, Ds, Ds, Ds, Ds, Ds, Ds, Ds, Ds, Ds, Ds, Wwf, Wwf, Wwf, Wwf, Wwf, Wwf, Wwf, Wwf, Wwf, Wwf, Wwf, Ds, Ds, Ds, Ds, Ds, Ds, Ds, Ds, Gg, Ds, Gg, Gg, Gg, Gg, Gd, Rd, Rd, Rd, Rd, Wwf, Wwf, Wwt, Wwf, Wwt, Wwt, Wwt, Wwt, Wwf, Gd, Gd, Gd, Gg, Gg, Gg, Gg, Gg, Ds, Wwt, Wwf, Wwt, Wwt, Wwf, Wwf, Wwf, Wwt, Wwt, Wwt, Wot, Wot, Wot, Wot
Ww^Vm, Wwf, Wwt, Wwf, Wwt, Wwf, Wwrg, Wwrg, Wwrg, Wwf, Wwf, Ds, Ds, Ds, Ds, Ds, Wwf, Wwf, Wwf, Wwf, Wwf, Wwf, Wwf, Wwf, Wwf, Wwf, Wwf, Wwf, Wwt, Wwf, Wwt, Wwt, Wwt, Ds, Wwt, Ds, Wwt, Ds, Wwf, Ds, Ds, Ds, Ds, Ds, Ds, Ds, Ds, Rd, Wwf, Wwf, Wwt, Wwt, Wwt, Wwt, Wwf, Wwf, Gd, Gd, Gd, Gd, Gd, Gd, Gg, Gg, Gg, Gg, Ds, Ds, Wwt, Wwt, Wwt, Wwt, Wwf, Wwt, Wwf, Wwt, Wwt, Wwt, Wwt, Wot, Wot, Wot
Wwt, Wwt, Wwt, Wwt, Wwt, Wwt, Wwrg, Wwt, Wwt, Wwt, Wwt, Wwf, Wwf, Wwf, Wwt, Wwt, Wwt, Wwt, Wwt, Wwt, Wwt, Ww^Vm, Wwt, Wwt, Wwt, Wwt, Wwt, Wwt, Wwt, Wwt, Wwt, Wwt, Wwt, Wwt, Wwt, Wwt, Wwf, Wwf, Wwf, Wwf, Wwt, Ds, Ds, Ds, Ds, Ds, Ds, Ds, Wwt, Wwt, Gd, Wwf, Gd, Gd, Gd, Gd, Gd, Gd, Gd, Gd, Gd, Gd, Gg, Gg, Ds, Ds, Wwt, Wwt, Wwt, Wwt, Wwt, Wwt, Wwt, Wwf, Wwf, Wwf, Wwf, Wwf, Wwt, Wwt, Wwt, Wwt
Wwt, Wwt, Wwt, Wwt, Wot, Wwt, Wwt, Wwt, Wwt, Wwt, Wwt, Wwt, Wwt, Wwt, Wwt, Wwt, Wwt, Wwt, Wot, Wwt, Wwt, Wwt, Wwt, Wwt, Wwt, Wwt, Wwt, Wwt, Wwt, Wwt, Wot, Wwt, Wwt, Wwt, Wwt, Wwt, Wwt, Wwt, Wwt, Wwf, Wwt, Wwt, Wwt, Ds, Wwt, Ds, Wwt, Wwt, Ds, Ds, Gd, Gd, Gd, Gd, Gg, Gg, Gg, Gd, Gd, Gd, Gg, Gg, Ds, Ds, Wwt, Wwt, Wwt, Wwt, Wwt, Wwt, Wwt, Wwt, Wwf, Wwf, Wwt, Wwf, Wwf, Wwt, Wwt, Wwt, Wwt, Wwt
Wot, Wot, Wot, Wot, Wot, Wot, Wot, Wot, Wot, Wot, Wot, Wot, Wot, Wot, Wot, Wot, Wot, Wot, Wot, Wot, Wot, Wot, Wot, Wot, Wot, Wot, Wot, Wot, Wot, Wot, Wot, Wot, Wot, Wot, Wot, Wot, Wot, Wwt, Wwt, Wwt, Wwt, Wwt, Wwt, Wwt, Wwt, Wwt, Wwt, Ds, Ds, Ds, Ds, Gd, Gg, Gg, Gg, Gg, Gg, Gg, Ds, Ds, Ds, Ds, Wwt, Wwf, Wwt, Wwt, Wwt, Wwt, Wot, Wot, Wot, Wwt, Wwt, Wwf, Wwt, Wwf, Wwf, Wwf, Ww^Vm, Wwt, Wwt, Wwt
Wot, Wot, Wot, Wot, Wot, Wot, Wot, Wot, Wot, Wot, Wot, Wot, Wot, Wot, Wot, Wot, Wot, Wot, Wot, Wot, Wot, Wot, Wot, Wot, Wot, Wot, Wot, Wot, Wot, Wot, Wot, Wot, Wot, Wot, Wot, Wot, Wot, Wot, Wot, Wwt, Wwt, Wwt, Wwt, Wwt, Wwt, Wwt, Wwt, Wwt, Wwt, Ds, Ds, Ds, Ds, Gg, Ds, Ds, Ds, Ds, Ds, Ds, Wwt, Wwt, Wwt, Wwt, Wwt, Wwt, Wot, Wot, Wot, Wot, Wot, Wot, Wot, Wwt, Wwt, Wwf, Wwt, Wwt, Wwf, Wwf, Wwt, Wwt
Wot, Wot, Wot, Wot, Wot, Wot, Wot, Wot, Wot, Wot, Wot, Wot, Wwt, Wot, Wot, Wot, Wot, Wot, Wot, Wot, Wot, Wot, Wot, Wot, Wot, Wot, Wot, Wot, Wot, Wot, Wot, Wot, Wot, Wot, Wot, Wot, Wot, Wot, Wot, Wwt, Wot, Wot, Wot, Wwt, Wwt, Wwt, Wwt, Wwt, Wwt, Ds, Ds, Ds, Ds, Ds, Wwt, Ds, Wwt, Ds, Wwt, Wwt, Wwt, Wwrt, Wwt, Wwt, Wwt, Wwt, Wwt, Wot, Wot, Wwt, Wwt, Wot, Wwt, Wot, Wwt, Wwt, Wwt, Wwt, Wwt, Wwf, Wwt, Wwt
Wot, Wot, Wot, Wot, Wot, Wot, Wot, Wot, Wot, Wot, Wot, Ww^Vm, Wwt, Wwt, Wwt, Wwt, Wwt, Wwt, Wwt, Wot, Wwrt, Wot, Ww^Vm, Wot, Wot, Wot, Wot, Wot, Wot, Wot, Wot, Wot, Wot, Wot, Wot, Wot, Wot, Wot, Wot, Wot, Wot, Wot, Wot, Wot, Wot, Wwt, Wwt, Wwt, Wwt, Wwt, Wwt, Wwt, Wwt, Wwt^Vm, Wwt, Wwt, Wwt, Wwt, Wwt, Wwt, Wwt, Wwrt, Wwrt, Wwt, Wwt, Wwt, Wwt, Wot, Wwrt, Wwt, Wwt, Wwt, Wwt, Wot, Wot, Wot, Wot, Wwt, Wwt, Wwf, Ds, Ds
Wot, Wot, Wot, Wot, Wot, Wot, Wot, Wot, Wot, Wot, Wwt, Wwt, Wwrt, Wwt, Wwt, Wwrt, Wwt, Wwt, Wwt, Wwrt, Wwt, Wwt, Wwt, Wwt, Wwt, Wot, Wot, Wot, Wot, Wot, Wot, Wot, Wot, Wot, Wot, Wot, Wot, Wot, Wot, Wot, Wot, Wot, Wwt, Wot, Wot, Wot, Wot, Wwt, Wwt, Wwt, Wwt, Wwt, Wwt, Wwt, Wwt, Wwt, Wwt, Wwt, Wwt, Wwt, Wwt, Wwrt, Wwrt, Wwrt, Wwrt, Wwt, Wwt, Wot, Wot, Wwrt, Wwrt, Wwt, Wwt, Wwt, Wot, Wot, Wot, Wwt, Wwt, Wwf, Ds, Ds
Wot, Wot, Wot, Wot, Wot, Wot, Wot, Wot, Wot, Wwt, Wot, Wwt, Wwt, Wwt, Wwt, Wwt, Ww^Vm, Wwt, Wot, Wwrt, Wot, Wwt, Wot, Wot, Wot, Wot, Wot, Wot, Wot, Wot, Wot, Wot, Wot, Wot, Wot, Wot, Wot, Wot, Wot, Wot, Wot, Wwt, Wwt, Wwt, Wwt, Wot, Wot, Wot, Wot, Wwt, Wwt, Wwt, Wwt, Wwt, Wwt, Wwt, Wot, Wwt, Wwt, Wwt, Wwt, Wwrt, Wwrt, Wwrt, Wwrt, Wwt, Wwt, Wot, Wot, Wwt, Wwt, Wwt, Wwrt, Wwrt, Wot, Wot, Wot, Wwrt, Wwrt, Wwt, Wwf, Ds
Wot, Wot, Wot, Wot, Wot, Wot, Wot, Wot, Wot, Wot, Wot, Wot, Wot, Wot, Wot, Wot, Wot, Wot, Wot, Wot, Wot, Wot, Wot, Wot, Wot, Wot, Wot, Wot, Wot, Wot, Wot, Wot, Wot, Wot, Wot, Wot, Wot, Wot, Wot, Wot, Wot, Wwt, Ww^Vm, Wwrg, Wwt, Wwt, Wot, Wot, Wot, Wot, Wot, Wot, Wot, Wot, Wot, Wot, Wot, Wot, Wot, Wwt, Wwt, Wwt, Wwt, Wwrt, Wwt, Wwrt, Wwt, Wot, Wot, Wot, Wwt, Wwt, Wwt, Wwt, Wot, Wot, Wwrt, Wwrt, Wwrt, Wwt, Ds, Ds
Wot, Wot, Wot, Wot, Wot, Wot, Wot, Wot, Wot, Wot, Wot, Wot, Wot, Wot, Wot, Wot, Wot, Wot, Wot, Wot, Wot, Wot, Wot, Wot, Wot, Wot, Wot, Wot, Wot, Wot, Wot, Wot, Wot, Wot, Wot^Edb, Wot^Edb, Wot^Edb, Wot, Wot, Wot, Wot^Vm, Wwt, Wwt, Wwt, Ww^Vm, Wwt, Wwt, Wot, Wot, Wot, Wot, Wot, Wot, Wot, Wot, Wot, Wot, Wot, Wot, Wwt, Wwt, Wwt, Wwrt, Wwt, Ww^Vm, Wwt, Wwt, Wot, Wot, Wot, Wwt, Wwt, Wot, Wot, Wot, Wot, Wwt, Wwrt, Wwt, Wwt, Ds, Ds
Wot, Wot, Wot, Wot, Wot, Wot, Wot, Wot, Wot, Wot, Wot, Wot, Wwt, Wot, Wwt, Wot, Wot, Wot, Wot, Wot, Wot, Wot, Wot, Wot, Wot, Wot, Wot, Wot, Wot, Wot, Wot, Wot, Wot, Wot^Edb, Wot, Wot, Wot, Wot, Wot, Wot, Wot, Wot, Wot, Wwt, Wwt, Wwt, Wwt, Wot, Wot, Wot, Wot, Wot, Wot, Wot, Wot, Wot, Wot, Wot, Wot, Wot, Wwt, Wwt, Wwt, Wwrt, Wwrt, Wwt, Wwt, Wwt, Wot, Wot, Wot, Wot, Wot, Wot, Wot, Wot, Wwt, Wwt, Wwt, Wwf, Ds, Ds
Wot, Wot, Wot, Wot, Wot, Wot, Wot, Wot, Wot, Wot, Wwt, Wwt, Wwt, Wwt, Wwt, Wwt, Wwt, Wwt, Wwt, Wot, Wwt, Wot, Wot, Wot, Wot, Wot, Wot, Wot, Wot, Wot, Wot, Wot, Wot, Wot, Wot, Wot, Wot, Wot, Wot, Wot^Edb, Wot, Wot, Wot, Wot, Wot, Wwt, Wwt, Wwt, Wot, Wot, Wot, Wot, Wot, Wot, Wot, Wot, Wot, Wot, Wot, Wot, Wwt, Wwt, Wwt, Wwt, Wwrt, Wwrt, Wwt, Wwt, Wot, Wot, Wot, Wot, Wot, Wot, Wot, Wot, Wwt, Wwt, Wwt, Wwf, Ds, Ds
Wwt, Wwt, Wwt, Wot, Wwt, Wwt, Wwt, Wot, Wwt, Wwt, Wwt, Wwt, Wwt, Wwt, Wwt, Wwt, Wwt, Ww^Vm, Wwt, Wwt, Wwt, Wwt, Wwt, Wwt, Ww^Vm, Wwt, Wwt, Wot, Wwt, Wot, Wwt, Wwt, Wwt, Wwt, Wwt, Wot, Wwt, Wot, Cm^Edb, Wot, Cm, Wot, Wot, Wot, Wot, Wot, Wot^Edb, Wot, Wot, Wot, Wot, Wot, Wot, Wot, Wot, Wot, Wot, Wot, Wot, Wot, Wot, Wwt, Wwt, Wwt, Wwt, Wwrt, Wwt, Wwt, Wot, Wot, Wot, Wot, Wot, Wot, Wot, Wot, Wwt, Wwt, Wwt, Wwf, Ds, Ds
Wwt, Wwt, Wwt, Wwt, Wwrg, Wwrg, Wwt, Wwt, Wwt, Wwt, Wwf, Wwf, Wwf, Wwt, Wwf, Wwt, Wwt, Wwt, Wwt, Wwt, Wwt, Wwt, Wwt, Wwt, Wwt, Wwt, Wwt, Wwt, Wwt, Wwt, Wwt, Wwt, Wwt, Wwt, Wwt, Ww^Vm, Wwt^Edb, Wwt, Wwt^Edb, Wot, Cm^Dr, Wot, Wot, Wot, Wot, Wot, Wot^Edb, Wot, Wot, Wot, Wot, Wot, Wot, Wot, Wot, Wot, Wot, Wot, Wot, Wot, Wot, Wot, Wot, Wwt, Wwt, Wwrt, Wwrt, Wwt, Wot, Wot, Wot, Wot, Wot, Wot, Wot, Wwt, Wwt, Wwt, Wwt, Wwf, Ds, Ds
Wwf, Wwf, Wwf, Wwf, Wwf, Wwrg, Ds, Wwrg, Ds, Wwf, Gg, Gg, Gg, Gg, Gg^Edb, Gg, Ds, Wwt, Wwt, Wwt, Wwt, Wwt, Ds, Wwt, Wwt, Wwt, Wwt, Wwt, Wwt, Wwt, Wwt, Wwt, Wwt^Es, Wwt, Wwf, Wwt, Wwt, Wwt^Edb, Wwt, Wwt^Edb, Wwt, Wot, Wot, Wot, Wot, Wot, Wot, Wot^Edb, Wot, Wot, Wot, Wot, Wot, Wot, Wot, Wot, Wot, Wot, Wot, Wot, Wot, Wot, Wot, Wot, Wwt, Wwt, Wwt, Wwt, Wwt, Wot, Wot, Wot, Wwt, Wot, Wwt, Wwt, Wwt, Wwt, Ds, Ds, Gd, Ds
Gg, Wwf, Gg, Wwf, Ds, Ds, Ds, Ds, Gs, Gs, Gs, Gg, Gg, Gg, Gg, Gg, Rd, Ds, Wwt, Ww^Vm, Ds, Ds, Rd, Gs, Gs, Wwf, Ds, Wwf^Es, Ds^Es, Wwt^Es, Wwf^Es, Wwt^Es, Wwf, Wwt^Es, Wwrg, Wwrg, Wwrg, Wwt^Es, Wwt, Wwt, Wwt, Wwt, Wwt, Wot, Wot, Wot, Wot^Edb, Wot, Wot, Wot, Wot, Wot, Wot, Wot, Wot, Wot, Wot, Wot, Wot, Wot, Wot, Wot, Wot, Wot, Wot, Wwt, Wwt, Wwt, Wwt, Wwt, Wwt, Wwt, Wwt, Wwt, Wwt, Wwt, Wwf, Wwf, Ds, Ds, Gd, Gd
Gg, Gg, Gs, Gs, Gs, Gs, Rd, Gs, Gs, Gg, Gs, Gg, Gg, Gg^Es, Gg, Gg^Edb, Gg^Edb, Ds, Wwt, Wwt, Rp, Rp, Gg, Gs^Edb, Gs, Rd, Rd, Ds^Es, Rd, Ds^Es, Ds^Es, Ds^Es, Ds^Es, Wwf^Es, Ds^Es, Wwf^Es, Wwf^Es, Wwrg, Wwf, Wwt, Wwt, Ww^Vm, Wwt, Wot, Wot, Wot^Edb, Wot, Wot, Wot, Wot, Wot, Wot, Wot, Wot, Wot, Wot, Wot, Wot, Wot, Wot, Wot, Wot, Wot, Wot, Wwt, Wwt, Wwt, Ww^Vm, Wwt, Wwt, Wwt, Wwt, Wwf, Wwt, Ds, Ds, Ds, Ds, Ds, Ds, Gd, Gd
Gg^Es, Gg, Gg, Gs, Gs, Gs, Gs, Gs, Gg, Gg, Gs, Gg^Es, Gg, Gg, Gg, Gg, Wwt, Wwt, Gg, Gg, Rp, Gg, Gg, Gg^Edb, Gg, Gs^Es, Gs, Rd, Rd^Edb, Rd^Edb, Rd^Edb, Ds, Gs^Edb, Ds, Ds, Ds^Es, Ds^Es, Wwf^Es, Wwt^Es, Wwt, Wwt, Wwt, Wwt, Wwt, Wot, Wot, Wot, Wot, Wot, Wot, Wot, Wot, Wot, Wot, Wot, Wot, Wot, Wot, Wot, Wot, Wot, Wot, Wot, Wwt, Wwt, Wwt, Wwf, Wwf, Wwt, Wwt, Wwt, Wwt, Wwf, Wwf, Ds, Ds, Gd, Gd, Gd, Gd, Gs, Gd
Gg, Gg, Gg, Gg, Gg, Gg, Gg, Gg, Gg, Gs, Hh, Gs, Gg, Gg, Wwt, Wwt, Gg, Gg^Vhr, Gg, Gg, Rp, Gg, Gg^Edb, Gg, Gg, Gg, Gg^Vc, Gs, Gs, Gs, Gs, Rd^Edb, Gs, Gs^Edb, Gs^Es, Ds, Ds, Ds^Es, Wwf^Es, Wwt^Es, Wwrg, Wwt, Wwt, Wwt, Wot, Wot, Wot, Wot, Wot, Wot, Wot, Wot, Wot, Wot, Wot, Wot, Wot, Wot, Wot, Wot, Wot, Wot, Wwt, Wwt, Wwt, Wwt, Wwf, Wwt, Wwt, Wwt, Ds, Wwf, Ds, Ds, Gd, Gd, Gs, Gs, Gs, Gs, Gs, Gs
Gg, Gg, Gg, Gg, Gg, Gg, Gg, Gg, Ss, Hh, Hh, Gs, Ss, Ss, Wwt, Ss, Gg^Es, Gg, Gg^Edb, Gg, Re, Gg, Gg, Gg, Gg, Gg^Edb, Gg, Gg, Gg, Gg, Gg, Gs, Gg, Gg, Gg, Gs, Gg^Es, Ds, Ds^Vht, Wwf^Es, Wwt^Es, Wwt, Wwt, Wwt, Wwt, Wot, Wot, Wot, Wot, Wot, Wot, Wot, Wot, Wot, Wot, Wot, Wot, Wot, Wot, Wot, Wot, Wot, Wwt, Wwt, Wwt, Wwf, Wwf, Wwf, Ds, Ds, Ds, Ds, Gd, Gd, Gd, Gd, Gs, Gs, Gs, Gs, Gs, Gs
Gg, Gg, Gg, Gg, Gg, Gg, Gg, Ss, Ss, Ss, Ss, Ss, Ss, Ss, Wwt, Ss, Ss, Gg^Edb, Gg, Gs^Edb, Re, Gg, Gg, Gg, Gs, Gg^Edb, Gg^Edb, Gg, Gg, Gg, Gg, Gg^Es, Gs, Gg, Gg, Gg, Gg, Gs, Ds, Wwf^Es, Wwf^Es, Wwt^Es, Wwt^Es, Wwt, Wwt, Wwt, Wwt, Wot, Wot, Wot, Wot, Wot, Wot, Wot, Wot, Wot, Wot, Wot, Wot, Wot, Wwt, Wwt, Wwt, Wwt, Wwf, Wwf, Ds, Ds, Gs, Gd, Gd, Gd, Gd, Gd, Gs, Gs^Edt, Gs^Ecf, Gs^Edt, Gs, Gs, Gg, Gs
Gg, Gg, Gg, Gg, Gg, Gg, Ss, Ss, Ss, Ss, Ss, Ss, Ss, Ss, Wwt, Ss, Ss, Gs^Fds, Gs, Rp, Gs^Edb, Gg, Gs, Gg, Gs^Vht, Gs, Gs, Gg, Gg, Gg, Gs, Gs, Hh, Gs, Gs, Gg, Gg, Gs, Gd, Ds, Ds, Wwf, Wwf^Es, Wwt, Wwt, Wwt, Wwt, Wwt, Wwt, Wot, Wot, Wot, Wot, Wot, Wot, Wot, Wot, Wot, Wot, Wot, Wwt, Wwt, Wwt, Wwt, Wwf, Wwf, Ds, Ds, Gs, Gs, Gs, Gs, Gs, Gs, Ce, Gs, Gg, Gs, Ce, Gg, Gg, Gs
Gg, Gg, Gg, Gg, Gg, Ss, Ss, Ss, Gg, Gg, Gs^Fds, Gg, Gg, Wwt, Ss, Ss, Ss, Ss, Ss, Rp, Gg, Gs^Edb, Gs^Edb, Gs, Gg, Gg, Gs, Gs, Gg, Gg, Gs, Hh, Gs, Hh, Hh, Gs, Gg, Gs, Gs, Ds, Ds, Ds^Es, Wwf^Es, Wwt, Wwt, Wwt, Wwt, Wwt, Wwt, Wwt, Wwt, Wot, Wot, Wot, Wwt, Wot, Wot, Wot, Wot, Wot, Wwt, Wwt, Wwt, Wwt, Wwf, Wwf, Ds, Ds, Gs, Gs, Gs, Gs, Gs, Ce, Ket, Ce, Ce, Ce, Ce, Gg, Gg, Gs
Gg, Gg, Gg, Gg, Gg, Ss, Ss, Ss, Gg, Gg, Gg, Gs^Vl, Wwt, Wwt^Bw\r, Ss, Ss, Ker, Ss, Wwf, Wwf, Ss, Gg, Ss, Gg, Gs, Gg, Gg, Gg, Gs, Gg, Gs, Gs, Gs^Vc, Gs, Gs, Gs, Gg, Gg, Gs, Gd^Es, Gd, Ds, Ds, Wwt, Wwt, Wwt, Wwt, Wwt, Wwt, Wwt, Wwt, Wwt, Wwt, Wwt, Wwt, Wwt, Wwt, Wwt, Wwt, Wwt, Wwt, Wwt, Wwt, Wwf, Ds, Ds, Ds, Gd, Gs, Gs, Gg, Gs, Gg, Ce, Gg, Ce, Gg, Ce, Gg, Gg, Gg, Gs
Gg, Gg, Gg, Gg, Ss, Ss, Ss, Ss, Gg, Gg, Wwt, Wwt, Gg, Ss, Ss, Cer^Edb, Cer, Ss, Ss, Wwf, Ss, Ss, Ss, Gg, Gs, Gs, Gs, Gs, Gs, Gs, Gs, Gs, Gs, Gs, Gg, Gg^Es, Gs, Hh, Gg, Gs, Gs, Gd, Gd, Ds, Wwf, Wwt, Wwf, Wwt, Wwf, Wwt, Wwt, Wwt, Wwrg, Wwrg, Wwrg, Wwt, Wwt, Wwt, Wwt, Wwt, Wwt, Wwt, Wwf, Wwf, Ds, Ds, Gd, Gd, Gs, Gg, Gg, Gg, Gg, Gg^Vhr, Gg, Gg, Gg^Es, Gg, Gg^Es, Gg^Es, Hh, Gs
Gg, Gg, Gg, Gg, Ss, Ss, Ss, Ss, Gg, Gs^Fds, Wwt, Gs^Fds, Gs^Fms, Ss, Ss, Ss, Ss, Ss, Ss, Wwf, Ss, Wwf, Ss, Gs, Gs^Es, Gs, Hh, Hh, Hh, Hh, Hh, Gs, Gs, Gg, Gg, Gg, Gg, Gs, Gg, Gg, Gg, Gs, Gs, Ds, Ds, Ds, Ds, Wwf, Ds, Wwf, Wwf, Wwf, Wwf, Wwrg, Wwrg, Wwrg, Wwt, Wwt, Wwt, Wwt, Wwt, Ds, Ds, Ds, Ds, Gd, Gd, Gs, Gs, Gg, Gs, Gg, Gg, Gg, Gg, Gg, Gg, Gg, Hh, Hh, Hh, Hh
Gg, Gg, Gg, Ss, Ss, Ss^Edb, Ss^Edb, Ss, Ss, Wwt, Ss, Gs^Fds, Gg, Gs^Fms, Gg, Ss, Ss^Edb, Wwf, Ss, Wwf, Ss, Ss, Gs, Gs, Gs, Hh, Hh, Hh, Hh, Hh, Hh, Hh, Gs, Gs, Gg, Gg, Gg, Gg, Gg, Gs^Edt, Gg, Gg, Gs, Gd, Gs, Gd, Gd, Ds, Ds, Ds, Ds, Wwf, Wwf, Wwf, Wwf, Wwf, Wwf, Ww^Vm, Wwf, Wwt, Wwt, Wwt, Wwt, Gd, Gd, Gd, Gs, Gs, Gs, Gs, Gd, Gs, Gs, Gs, Gs, Gg, Gg, Hh, Hh, Hh, Hh, Hh
Gg, Gg, Ss, Ss^Edb, Ss, Ss, Ss^Edb, Ss^Edb, Ss^Edb, Ss, Ss, Ss, Ss, Ss, Ss, Ss, Gg, Ss, Re, Ss, Gg, Gg, Gs, Gs, Gs, Gs, Hh, Hh, Mm, Mm, Mm, Hh, Hh, Gs, Gg, Gg, Gg, Gg, Gg, Gg, Gg^Vhr, Gg, Gg, Gs, Gg, Gs, Gs, Gd, Gd, Ds, Ds, Ds, Ds, Wwf, Ds, Wwf, Wwf, Wwf, Wwf, Ds, Ds, Ds, Ds, Wwt, Wwt, Gs, Wwt, Gs, Gs, Gs, Gs, Gs, Gs, Gs, Gs, Gg, Gg, Gg, Gg, Gg, Gg, Gs
Gg, Ss, Ss^Edb, Ss^Edb, Ss^Edb, Ss^Edb, Ss^Edb, Ss, Ss, Ss^Edb, Ss, Ss, Gg, Gg, Gg, Gg, Rp, Re, Gg, Gg, Gg, Gg, Gg, Gs, Gs, Hh, Hh, Mm^Vhh, Mm, Mm, Mm, Hh, Hh, Gs, Gg, Gg, Gg, Gg, Gs, Gg, Gg, Gg, Gg^Edt, Gg, Gg, Gg, Gg, Gs, Gs, Gd, Gd, Ds, Ds, Ds, Ds, Ds, Ds, Ds, Ds, Ds, Ds, Ds, Gd, Gd, Gs, Wwt, Gg, Wwt, Wwt^Es, Gs, Gg, Gg, Gg, Gg, Gg, Gg, Gg, Gg, Gg, Gg, Gg, Gs
Gg, Gg, Ss, Ss, Ss, Ss, Ss, Ss^Edb, Ss^Edb, Ss^Edb, Ss, Gg, Gg, Gg^Vhr, Gg, Rp, Gg, Gg, Gg, Gg, Gg^Es, Gg, Gg, Gs, Gs, Hh, Hh, Hh, Hh, Mm, Mm, Hh, Hh, Gs, Gg^Es, Gg^Es, Gg, Gg, Gs, Gg, Gs, Gg, Gg, Gg, Gg, Gg^Edt, Gg^Edt, Gs, Gs, Gs, Gs, Gd, Gd, Ds, Ds, Ds, Ds, Ds, Ds, Ds, Ds, Gd, Gs, Gs, Gs, Gs, Gs, Gs, Gs, Wwt, Wwt, Gg, Gg, Gg^Vhr, Gg, Gg, Gg, Gg, Gg, Gg, Gg, Gs
Gg, Gg, Ss, Ss, Ss, Ss, Ss, Ss, Gg, Gg, Gg, Gg^Es, Gs, Gs, Gg, Rp, Gg, Gg, Gg, Gg, Gg, Gg^Es, Gg^Es, Gg, Gg, Gs^Es, Gs^Es, Hh, Hh, Mm, Mm, Mm, Hh, Gs, Gs^Vl, Gg^Es, Gg, Gs, Gd, Gs, Gs, Gg, Gg, Gg, Gg, Gg, Gg^Edt, Gg, Hh, Gs, Gg, Gs, Gs, Gd, Gd, Gd, Gd, Gd, Gd^Edt, Gd, Gd, Gs, Gs, Gs, Gg, Gg, Hh, Gs^Es, Gs^Es, Gs, Gs, Wwt, Wwt, Gg, Ds, Gg, Gg, Gg, Gg, Gg, Gg, Gs
Gg, Gg, Gg, Gg, Gg, Ss, Ss, Ss, Ss, Gg, Gs, Gs, Gs, Gg, Gg, Re, Gg, Gg, Gg, Gg, Gs, Gs, Gg, Gg, Gg, Gg, Gg, Gs^Es, Gs, Hh, Hh, Mm, Hh, Gs, Gg^Es, Gg^Es, Gg, Gs, Gs, Gd, Gs, Gs, Gg, Gg, Gg, Gg^Vhr, Gg, Gg, Hh, Hh^Es, Hh, Gg, Gs, Gs, Gs, Gg, Gs, Gs, Gs^Edt, Gs, Gs, Gs, Gs, Gs, Gg, Gg, Hh, Hh, Hh, Gs, Gg^Es, Gs, Ss, Wwt, Wwt, Ds, Ds, Ds, Ds, Ds, Ds, Gs
Gg^Vhr, Gg^Es, Gg, Gg, Gg, Ss, Gg, Ss, Gg, Gs, Gs, Gs, Gg, Gg, Gg, Re, Gg, Gg, Gg^Vhr, Gs, Gs, Gs, Gs, Gg, Gg, Gg^Es, Gg, Gg^Es, Gs, Gs, Gs, Hh, Gs, Gs, Gg, Gg, Gg, Gs, Gs, Gs, Gs, Gs, Gs, Gg^Edt, Gg, Gg, Gg, Gg^Es, Hh, Hh, Hh, Hh, Gg, Gg, Gs, Gs, Gs, Gs, Gg, Gg^Edt, Gg^Edt, Gs, Gs, Gs, Gg, Hh, Hh, Hh^Dr, Hh, Hh, Gg, Gg, Ss, Ss, Wwt, Wwt^Es, Wwt, Wwt, Wwt, Ds, Ds, Ds
Gg, Gg, Gg, Gg, Gg, Gg, Gg, Gg, Gg, Gs, Gg, Gg, Hh, Hh, Gg, Rp, Gg, Gg, Gg, Gs, Gs, Gs, Gs, Gs, Gg, Gg^Es, Gg, Gg^Es, Gg, Gg, Gg, Gs, Gs, Gs, Gg, Gg, Gg, Gg, Gg, Gg, Gg, Gg, Gg, Gg^Edt, Gg, Gg, Gg, Hh, Gg^Es, Hh, Hh, Hh, Gg, Gg, Gg, Gs, Gs, Gs, Gg, Gg^Edt, Gg, Gg, Gg, Gs, Gg, Gg, Gg^Es, Gg^Es, Hh, Hh, Gg, Ss, Ss, Ss, Wwt, Wwt, Wot, Wwt, Wwt, Wwt, Ds, Ds
Gg, Gg, Gg, Gg, Gg^Es, Gg, Gg, Gg, Gg, Gg^Es, Gg^Es, Hh, Gg, Hh, Gg, Rp, Gg, Gg, Gg, Gg, Gg, Gg, Gg, Gg, Gg, Gg, Gg, Gg, Gg, Gg, Gg, Gg, Gg, Gg, Gg, Gg, Gg, Gg, Gg, Gg, Gg, Gg, Gg, Gg, Gg, Gg, Gg, Gg, Gg, Gg^Es, Gg, Gg, Gg, Gg, Gg, Gs, Gs, Gs, Gs, Gg, Gg, Gg, Gg, Gg, Gg, Gg, Gg, Gg^Es, Gg, Gg, Gg, Ss, Ss, Wwt, Wwt, Wwt, Wwt, Wot, Wwt, Wwt, Ds, Ds
Gg, Gg, Gg, Gg, Gg, Gg, Gg, Gg, Gg, Gg, Gg, Gg^Es, Gg^Es, Gg, Gg, Rp, Gg, Gg, Gg, Gg, Gg, Gg, Gg, Gg, Gg, Gg, Gg, Gg, Gg, Gg, Gg, Gg, Gg, Gg, Gg, Gg, Gg, Gg, Gg, Gg, Gg, Gg, Gg, Gg, Gg, Gg, Gg, Gg, Gg, Gg^Es, Gg, Gg, Gg, Gg, Gg, Gg, Gg, Gg, Gg, Gg, Gg, Gg, Gg, Gg, Gg, Gg, Gg, Gg, Gg, Gg, Gg, Gg, Gg, Ds, Ww^Vm, Wwt, Wwt, Wwt^Es, Wwt, Wwt, Ss, Ds
Gg, Gg, Gg, Gg, Gg, Gg, Gg, Gg, Gg, Gg, Gg, Gg, Gg, Gg, Gg, Rp, Gg, Gg, Gg, Gg, Gg, Gg, Gg, Gg, Gg, Gg, Gg, Gg, Gg, Gg, Gg, Gg, Gg, Gg, Gg, Gg, Gg, Gg, Gg, Gg, Gg, Gg, Gg, Gg, Gg, Gg, Gg, Gg, Gg, Gg, Gg, Gg, Gg, Gg, Gg, Gg, Gg, Gg, Gg, Gg, Gg, Gg, Gg, Gg, Gg, Gg, Gg, Gg, Gg, Gg, Gg, Gg, Gg, Ds, Ds, Wwt, Ds, Wwt, Ds, Ss, Gg, Ds
Gg, Gg, Gg, Gg, Gg, Gg, Gg, Gg, Gg, Gg, Gg, Gg, Gg, Gg, Gg, Rp, Gg, Gg, Gg, Gg, Gg, Gg, Gg, Gg, Gg, Gg, Gg, Gg, Gg, Gg, Gg, Gg, Gg, Gg, Gg, Gg, Gg, Gg, Gg, Gg, Gg, Gg, Gg, Gg, Gg, Gg, Gg, Gg, Gg, Gg, Gg, Gg, Gg, Gg, Gg, Gg, Gg, Gg, Gg, Gg, Gg, Gg, Gg, Gg, Gg, Gg, Gg, Gg, Gg, Gg, Gg, Gg, Gg, Gg, Gg, Ds, Gg, Ds, Gg, Gg, Hh, Ds
