Wo, Wo, Wo, Wo, Wo, Wo, Wo, Wo, Wo, Wo, Wo, Wo, Wo, Wo, Wo, Wo, Wo, Wo, Wo, Wo, Wo, Wo, Wo, Wo, Wo, Wo, Wo, Wo
Wo, Wo, Wo, Wo, Wo, Wo, Wo, Wo, Wo, Wo, Wo, Wo, Wo, Wo, Wo, Wo, Ww, Wo, Ww, Wo, Ww, Wo, Wo, Wo, Wo, Wo, Wo, Wo
Wo, Wo, Wo, Wo, Wo, Wo, Wo, Wo, Wo, Wo, Wo, Wo, Wo, Wo, Wwg, Wwg, Cme, Ww, Ww, Ww, Ww, Wo, Wo, Wo, Wo, Wo, Wo, Wo
Wo, Wo, Wo, Wo, Wo, Wo, Wo, Wo, Wo, Wo, Wo, Wo, Wo, Wwg, Cme, 1 Kme, Cme, Ds, Gs^Fds, Ds, Ww, Ww, Wo, Wo, Wo, Wo, Wo, Wo
Wo, Wo, Wo, Wo, Wo, Wo, Wo, Wo, Wo, Wo, Wo, Wo, Wo, Wwg, Cme, Cme, Ds, Gs^Fms, Gs^Fms, Ds, Ww^Edb, Ww, Ww, Wo, Wo, Wo, Wo, Wo
Wo, Wo, Wo, Wo, Wo, Ww, Ww, Ww, Ww, Wo, Wo, Wo, Wo, Wwr, Ww, Ww, Wwg, Dd^Ftd, Ds, Gs^Fms, Ds, Ww, Ww, Wo, Wo, Wo, Wo, Wo
Wo, Wo, Wo, Wo, Ww, Ww, Ww, Ww, Ww, Ww, Wwg, Wwg, Wwg, Ww, Ww, Ww, Ww, Wwg, Wwg, Wwg, Ww, Ww, Wo, Wo, Wo, Wo, Wo, Wo
Wo, Wo, Wo, Wo, Ww, Ww, Ds, Ds, Ds, Ds, Dd^Ftd, Wwg, Wwg, Ww, Wo, Wo, Wo, Wwg, Wwg, Wwg^Vm, Ww, Ww, Wo, Wo, Wo, Wo, Wo, Wo
Wo, Wo, Wo, Wo, Ww, Ww^Edt, Ds, Gs^Fms, Rb, Gs, Gs^Fms, Ds, Ww, Wo, Wo, Wo, Wo, Ww, Ww, Wo, Wo, Wo, Wo, Wo, Wo, Wo, Wo, Wo
Wo, Wo, Wo, Wwrg, Wwg, Ww, Ds, Dd^Ftd, Gll^Fmw, Gs^Vhc, Rb, Ds, Ww, Ww, Wo, Wo, Wwr, Ww, Wo, Wo, Wo, Wo, Wo, Wo, Wog, Wo, Wog, Wog
Wo, Wo, Wo, Wog, Wwg, Wwg, Wwg, Ds, Dd^Ftd, Gs, Ds, Dd^Ftd, Ww, Ww, Ww, Wo, Ww, Ww, Ww, Wog, Wo, Wo, Wo, Wo, Wog, Wog, Wog, Wog
Wo, Wo, Wo, Wo, Wo, Wwg, Wwg^Vm, Wwf, Wwf, Ds, Ww, Ww, Ww, Wwr, Wwr, Ww, Ww, Ds, Ww, Wog^Edt, Wo, Wo, Wo, Wo, Wog, Wog, Wo, Wo
Wo, Wo, Wo, Wo, Wo, Wwg, Wwg, Wwf, Wwg, Wwg, Ww, Ww, Wo, Wo, Wo, Wo, Wog, Ww, Ww, Wog, Wo, Wo, Wo, Wo, Wog, Wo, Wo, Wo
Wo, Wo, Wo, Wo, Wo, Wwg, Wwg, Wwf, Wwg, Wwg, Wo, Wo, Wo, Wo, Wog, Wog, Wog, Wog, Wog, Wog, Wog, Wo, Wog, Wog, Wog, Wo, Wo, Wo
Wog, Wo, Wo, Wo, Wog, Wog, Wwg, Wwg, Wwf, Wwg, Wog, Wo, Wog, Wog, Wo, Wog, Wog, Wog, Wog, Wog, Wog, Wog, Wog, Wog, Wog, Wo, Wo, Wo
Wog, Wo, Wo, Wo, Wog, Wog, Wog, Wwg, Wwf, Wwg, Wwg, Wog, Wog, Wo, Wo, Wo, Wo, Wog, Wog, Wog, Wog, Wog, Wog, Wog, Wo, Wo, Wo, Wo
Wog, Wo, Wo, Wo, Wog, Wog, Wog, Wwrg, Wwrg, Wwf, Wwg, Wwg, Wwg, Wo, Wo, Wo, Ww, Wog, Wog, Wog, Wog, Wog, Wog, Wo, Wo, Wo, Wo, Wo
Wog, Wo, Wo, Wo, Wog, Wog, Wog, Wog, Wog, Wwg, Wwf, Wwrg, Wwrg, Wwg, Ww, Ww, Ww, Ww, Ww, Wwg, Wwg, Wog, Wog, Wo, Wo, Wo, Wo, Wo
Wog, Wo, Wo, Wo, Wog, Wog, Wo, Wog, Wwg, Wwg, Wwf, Wwf, Ds, Wwg, Ss, Ww, Ds, Ds, Ds, Wwg, Wwg, Wwrg, Wog, Wo, Wo, Wo, Wo, Wo
Wog, Wog, Wog, Wog, Wog, Wo, Wo, Wo, Ww, Wwg, Wwf, Ds, Ss, Ds, Hh, Ds, Gs^Fms, Dd^Ftd, Gs, Wwg, Ds, Wwg, Wwg, Wog, Wog, Wo, Wo, Wo
Wog, Wog, Wog, Wog, Wog, Wo, Ww, Ww, Ds, Ds, Dd^Ftd, Ds, Gs^Fds, Gg, Chs, Ds, Gll^Fmw, Rb, Ww^Vm, Wwg, Ds, Wwg, Wwg, Wog, Wog, Wog, Wog, Wog
Wog, Wog, Wog, Wog, Wog, Wo, Ww, Ww, Ds, Ss, Ss, Gll^Fmw, Rb, Gs^Fms, Chs, Chs, Chs, Chs, Ww, Ds, Wwg, Wwg, Wog, Wog, Wog, Wog, Wog, Wog
Wog, Wog, Wog, Wog, Wog, Wo, Wo, Ww, Wwg, Ds, Gg, Ss, Gs, Ds, Chs, 2 Kh, Ds, Chs, Ds, Wwg^Edb, Wwg, Wwg, Wog, Wog, Wog, Wog, Wog, Wog
Wog, Wog, Wog, Wog, Wog, Wo, Wo, Wwg, Wwg, Ds, Dd^Ftd, Gs^Fms, Ss, Chs, Ss, Chs, Gll^Fmw, Gs^Fms, Ds, Wwg, Wog, Wog, Wog, Wog, Wog, Wog, Wog, Wog
Wog, Wog, Wog, Wog, Wog, Wog, Wog, Wwg, Wwg, Ds, Wwg, Ds, Wwg^Edb, Ss, Ss, Gs, Ds, Dd^Ftd, Ww, Wwg, Wog, Wog, Wog, Wog, Wog, Wog, Wog, Wog
Wog, Wog, Wog, Wog, Wog, Wog, Wog, Wwg, Wwg, Wwg, Wwg, Wwg, Wwg, Ss^Vhs, Ds, Ds, Ww, Ds, Ww, Ww, Wog, Wog, Wog, Wog, Wog, Wog, Wog, Wog
Wog, Wog, Wog, Wog, Wog, Wog, Wog, Wog, Wog, Wwg, Wwg, Wwg, Wwg, Wwg, Ww, Ww, Ww, Ww, Wo, Wo, Wog, Wog, Wog, Wog, Wog, Wog, Wog, Wog
Wog, Wog, Wog, Wog, Wog, Wog, Wog, Wog, Wog, Wog, Wog, Wwg, Wog, Wwg, Wo, Ww, Wo, Wo, Wo, Wo, Wog, Wog, Wog, Wog, Wog, Wog, Wog, Wog
Wog, Wog, Wog, Wog, Wog, Wog, Wog, Wog, Wog, Wog, Wog, Wog, Wo, Wo, Wo, Wo, Wo, Wo, Wo, Wo, Wog, Wog, Wog, Wog, Wog, Wog, Wog, Wog
Wog, Wog, Wog, Wog, Wog, Wog, Wog, Wog, Wog, Wog, Wog, Wo, Wo, Wo, Wo, Wo, Wo, Wo, Wo, Wo, Wog, Wog, Wog, Wog, Wog, Wog, Wog, Wog
